//MAP CONVERTED BY dmm2tgm.py THIS HEADER COMMENT PREVENTS RECONVERSION, DO NOT REMOVE
"aV" = (
/obj/effect/turf_decal/tile/purple{
	dir = 1
	},
/obj/structure/table,
/turf/open/indestructible,
/area/space)
"dA" = (
/obj/effect/turf_decal/stripes/line{
	dir = 4
	},
/obj/effect/turf_decal/stripes/white/line{
	dir = 4
	},
/obj/effect/turf_decal/tile/purple{
	dir = 8
	},
/turf/open/indestructible,
/area/space)
"dI" = (
/obj/machinery/computer{
	dir = 8
	},
/obj/effect/turf_decal/tile/blue,
/turf/open/indestructible/white,
/area/space)
"dY" = (
/obj/effect/turf_decal/stripes/line{
	dir = 8
	},
/obj/structure/window/reinforced/spawner/directional/west,
/turf/open/indestructible/white,
/area/space)
"fL" = (
/obj/effect/turf_decal/tile/neutral{
	dir = 4
	},
/obj/machinery/light/no_nightlight/directional/east,
/turf/open/indestructible,
/area/space)
"hL" = (
/obj/structure/table,
/obj/machinery/light/no_nightlight/directional/north,
/turf/open/indestructible,
/area/space)
"ia" = (
/turf/closed/indestructible/fakeglass,
/area/space)
"il" = (
/obj/structure/frame/machine/secured,
/turf/open/indestructible/hoteltile,
/area/space)
"kE" = (
/obj/machinery/door/airlock/public/glass{
	name = "Arrivals"
	},
/turf/open/indestructible/large,
/area/space)
"lq" = (
/obj/effect/turf_decal/stripes/corner{
	dir = 1
	},
/obj/effect/turf_decal/stripes/white/corner{
	dir = 1
	},
/turf/open/indestructible,
/area/space)
"lJ" = (
/turf/closed/indestructible/reinforced,
/area/space)
"nS" = (
/obj/structure/cable,
/obj/structure/cable,
/turf/open/indestructible,
/area/space)
"ox" = (
/obj/structure/fluff/fake_camera{
	dir = 5
	},
/turf/open/indestructible,
/area/space)
"qa" = (
/turf/open/indestructible/dark/smooth_large,
/area/space)
"qV" = (
/obj/effect/turf_decal/stripes/corner{
	dir = 8
	},
/obj/effect/turf_decal/stripes/white/corner{
	dir = 8
	},
/turf/open/indestructible,
/area/space)
"sx" = (
/obj/structure/railing/corner/end{
	dir = 1
	},
/turf/open/indestructible,
/area/space)
"tv" = (
/obj/effect/turf_decal/tile/purple{
	dir = 4
	},
/turf/open/indestructible/hoteltile,
/area/space)
"tU" = (
/obj/structure/table,
/turf/open/indestructible,
/area/space)
"uc" = (
/obj/structure/frame/machine/secured,
/turf/open/indestructible,
/area/space)
"vq" = (
/obj/effect/turf_decal/stripes/line{
	dir = 5
	},
/obj/structure/stairs_frame{
	dir = 8
	},
/turf/open/indestructible/plating,
/area/space)
"wM" = (
/obj/structure/table/glass,
/obj/effect/turf_decal/tile/blue{
	dir = 4
	},
/turf/open/indestructible/white,
/area/space)
"xr" = (
/obj/machinery/door/airlock/research{
	name = "Research"
	},
/turf/open/indestructible/large,
/area/space)
"ze" = (
/obj/effect/turf_decal/stripes/line{
	dir = 10
	},
/obj/structure/stairs_frame{
	dir = 1
	},
/turf/open/indestructible/plating,
/area/space)
"Ae" = (
/obj/machinery/door/airlock/research{
	name = "Genetics"
	},
/turf/open/indestructible/white/smooth_large,
/area/space)
"Al" = (
/obj/effect/turf_decal/stripes/line{
	dir = 8
	},
/obj/structure/showcase/machinery/implanter,
/obj/structure/window/reinforced/spawner/directional/west,
/turf/open/indestructible/white,
/area/space)
"AG" = (
/obj/machinery/computer,
/obj/effect/turf_decal/tile/blue{
	dir = 4
	},
/obj/machinery/light/no_nightlight/directional/north,
/turf/open/indestructible/white,
/area/space)
"AP" = (
/obj/structure/rack,
/turf/open/indestructible,
/area/space)
"BB" = (
/obj/effect/turf_decal/stripes/line,
/obj/effect/turf_decal/stripes/white/line,
/turf/open/indestructible,
/area/space)
"BX" = (
/obj/effect/turf_decal/tile/purple{
	dir = 8
	},
/turf/open/indestructible/hoteltile,
/area/space)
"En" = (
/obj/machinery/vending/wardrobe/science_wardrobe{
	active = 0
	},
/turf/open/indestructible,
/area/space)
"EB" = (
/turf/open/indestructible/large,
/area/space)
"Gh" = (
/obj/effect/turf_decal/stripes/line{
	dir = 1
	},
/obj/effect/turf_decal/stripes/white/line{
	dir = 1
	},
/obj/structure/railing,
/turf/open/indestructible,
/area/space)
"GS" = (
/obj/structure/railing{
	dir = 4
	},
/turf/open/indestructible,
/area/space)
"Hv" = (
/obj/effect/turf_decal/tile/blue,
/obj/structure/extinguisher_cabinet/directional/west,
/turf/open/indestructible/white,
/area/space)
"HE" = (
/turf/open/indestructible/white,
/area/space)
"Ip" = (
/obj/machinery/light/no_nightlight/directional/north,
/turf/open/indestructible,
/area/space)
"II" = (
/obj/item/stack/sheet/animalhide/monkey,
/obj/effect/decal/cleanable/glass,
/turf/open/indestructible/plating,
/area/space)
"IK" = (
/obj/effect/turf_decal/stripes/line{
	dir = 1
	},
/obj/effect/turf_decal/stripes/white/line{
	dir = 1
	},
/obj/structure/railing/corner/end/flip{
	dir = 8
	},
/turf/open/indestructible,
/area/space)
"Kk" = (
/obj/effect/turf_decal/tile/blue/opposingcorners,
/turf/open/indestructible/white,
/area/space)
"LW" = (
/obj/structure/fluff/fake_firedoor,
/obj/structure/table/reinforced,
/obj/structure/sign/departments/genetics/directional/west,
/obj/structure/railing/corner,
/turf/open/indestructible/plating,
/area/space)
"Pn" = (
/obj/effect/turf_decal/tile/neutral{
	dir = 4
	},
/obj/effect/turf_decal/tile/blue,
/turf/open/indestructible,
/area/space)
"Pu" = (
/obj/structure/showcase/machinery/implanter,
/obj/effect/turf_decal/tile/blue,
/turf/open/indestructible/white,
/area/space)
"PB" = (
/obj/structure/fluff/fake_firedoor,
/turf/open/indestructible/large,
/area/space)
"Qi" = (
/turf/closed/indestructible/fakedoor/glass_airlock,
/area/space)
"QF" = (
/obj/effect/turf_decal/tile/purple{
	dir = 8
	},
/turf/open/indestructible,
/area/space)
"Rt" = (
/turf/open/indestructible/plating,
/area/space)
"RD" = (
/obj/effect/turf_decal/stripes/corner{
	dir = 4
	},
/obj/effect/turf_decal/stripes/white/corner{
	dir = 4
	},
/obj/effect/turf_decal/tile/purple{
	dir = 8
	},
/obj/structure/railing/corner,
/obj/structure/fluff/fake_camera{
	dir = 5
	},
/turf/open/indestructible,
/area/space)
"SJ" = (
/obj/machinery/vending/wardrobe/gene_wardrobe{
	active = 0
	},
/obj/effect/turf_decal/tile/blue{
	dir = 4
	},
/obj/structure/fluff/fake_camera{
	dir = 4
	},
/turf/open/indestructible/white,
/area/space)
"Un" = (
/obj/effect/turf_decal/stripes/line{
	dir = 8
	},
/obj/effect/turf_decal/stripes/white/line{
	dir = 8
	},
/turf/open/indestructible,
/area/space)
"UM" = (
/turf/open/indestructible,
/area/space)
"Vi" = (
/turf/open/space/basic,
/area/space)
"Xx" = (
/obj/structure/frame/computer,
/turf/open/indestructible/hoteltile,
/area/space)
"XD" = (
/obj/effect/turf_decal/tile/purple{
	dir = 4
	},
/turf/open/indestructible,
/area/space)
"XY" = (
/obj/effect/turf_decal/stripes/line{
	dir = 4
	},
/obj/effect/turf_decal/stripes/white/line{
	dir = 4
	},
/turf/open/indestructible,
/area/space)
"Yb" = (
/obj/structure/sign/warning/docking/directional/north,
/turf/open/indestructible,
/area/space)
"ZU" = (
/obj/effect/turf_decal/stripes/line{
	dir = 8
	},
/obj/effect/decal/cleanable/glass,
/obj/item/shard,
/turf/open/indestructible/white,
/area/space)
"ZX" = (
/obj/effect/turf_decal/stripes/corner,
/obj/effect/turf_decal/stripes/white/corner,
/turf/open/indestructible,
/area/space)

(1,1,1) = {"
Vi
Vi
Vi
Vi
Vi
Vi
Vi
Vi
Vi
Vi
Vi
Vi
Vi
Vi
Vi
Vi
Vi
Vi
Vi
Vi
Vi
Vi
Vi
Vi
Vi
Vi
Vi
Vi
Vi
Vi
Vi
Vi
Vi
Vi
Vi
Vi
Vi
Vi
Vi
Vi
"}
(2,1,1) = {"
Vi
Vi
Vi
Vi
Vi
Vi
Vi
Vi
Vi
Vi
Vi
Vi
Vi
lJ
ia
ia
ia
lJ
Vi
Vi
Vi
ia
Qi
ia
Qi
ia
Vi
Vi
Vi
Vi
Vi
Vi
Vi
Vi
Vi
Vi
Vi
Vi
Vi
Vi
"}
(3,1,1) = {"
Vi
Vi
Vi
Vi
Vi
Vi
Vi
Vi
Vi
Vi
Vi
Vi
Vi
ia
II
Rt
Rt
ia
Vi
Vi
Vi
ia
qa
lJ
qa
ia
Vi
Vi
Vi
Vi
Vi
Vi
Vi
Vi
Vi
Vi
Vi
Vi
Vi
Vi
"}
(4,1,1) = {"
Vi
Vi
Vi
Vi
Vi
Vi
Vi
Vi
Vi
Vi
Vi
Vi
Vi
lJ
Al
ZU
dY
lJ
lJ
lJ
ia
ia
Qi
lJ
Qi
lJ
Vi
Vi
Vi
Vi
Vi
Vi
Vi
Vi
Vi
Vi
Vi
Vi
Vi
Vi
"}
(5,1,1) = {"
Vi
Vi
Vi
Vi
Vi
Vi
Vi
Vi
Vi
Vi
Vi
Vi
Vi
lJ
AG
HE
Kk
HE
Hv
LW
GS
sx
UM
UM
UM
lJ
Vi
Vi
Vi
Vi
Vi
Vi
Vi
Vi
Vi
Vi
Vi
Vi
Vi
Vi
"}
(6,1,1) = {"
Vi
Vi
Vi
Vi
Vi
Vi
Vi
Vi
Vi
Vi
Vi
Vi
Vi
lJ
SJ
wM
HE
Pu
dI
lJ
ze
Pn
fL
UM
ox
lJ
Vi
Vi
Vi
Vi
Vi
Vi
Vi
Vi
Vi
Vi
Vi
Vi
Vi
Vi
"}
(7,1,1) = {"
Vi
Vi
Vi
Vi
Vi
Vi
Vi
Vi
Vi
Vi
Vi
Vi
Vi
lJ
lJ
lJ
Ae
lJ
lJ
lJ
lJ
lJ
lJ
kE
kE
lJ
Vi
Vi
Vi
Vi
Vi
Vi
Vi
Vi
Vi
Vi
Vi
Vi
Vi
Vi
"}
(8,1,1) = {"
Vi
Vi
Vi
Vi
Vi
Vi
Vi
Vi
Vi
Vi
Vi
Vi
Vi
Vi
lJ
aV
ZX
dA
XY
dA
RD
lJ
lJ
Yb
UM
Vi
Vi
Vi
Vi
Vi
Vi
Vi
Vi
Vi
Vi
Vi
Vi
Vi
Vi
Vi
"}
(9,1,1) = {"
Vi
Vi
Vi
Vi
Vi
Vi
Vi
Vi
Vi
Vi
Vi
Vi
Vi
Vi
lJ
tU
BB
Xx
tv
il
Gh
vq
lJ
UM
UM
Vi
Vi
Vi
Vi
Vi
Vi
Vi
Vi
Vi
Vi
Vi
Vi
Vi
Vi
Vi
"}
(10,1,1) = {"
Vi
Vi
Vi
Vi
Vi
Vi
Vi
Vi
Vi
Vi
Vi
Vi
Vi
Vi
lJ
hL
BB
il
BX
il
IK
QF
lJ
UM
UM
Vi
Vi
Vi
Vi
Vi
Vi
Vi
Vi
Vi
Vi
Vi
Vi
Vi
Vi
Vi
"}
(11,1,1) = {"
Vi
Vi
Vi
Vi
Vi
Vi
Vi
Vi
Vi
Vi
Vi
Vi
Vi
Vi
lJ
AP
qV
Un
Un
Un
lq
QF
lJ
UM
UM
Vi
Vi
Vi
Vi
Vi
Vi
Vi
Vi
Vi
Vi
Vi
Vi
Vi
Vi
Vi
"}
(12,1,1) = {"
Vi
Vi
Vi
Vi
Vi
Vi
Vi
Vi
Vi
Vi
Vi
Vi
Vi
Vi
lJ
En
UM
UM
UM
UM
UM
QF
lJ
UM
UM
Vi
Vi
Vi
Vi
Vi
Vi
Vi
Vi
Vi
Vi
Vi
Vi
Vi
Vi
Vi
"}
(13,1,1) = {"
Vi
Vi
Vi
Vi
Vi
Vi
Vi
Vi
Vi
Vi
Vi
Vi
Vi
Vi
lJ
lJ
EB
lJ
Ip
UM
UM
UM
lJ
UM
UM
UM
Vi
Vi
Vi
Vi
Vi
Vi
Vi
Vi
Vi
Vi
Vi
Vi
Vi
Vi
"}
(14,1,1) = {"
Vi
Vi
Vi
Vi
Vi
Vi
Vi
Vi
Vi
Vi
Vi
Vi
Vi
Vi
Vi
Vi
Vi
lJ
xr
ia
ia
xr
lJ
nS
UM
UM
Vi
Vi
Vi
Vi
Vi
Vi
Vi
Vi
Vi
Vi
Vi
Vi
Vi
Vi
"}
(15,1,1) = {"
Vi
Vi
Vi
Vi
Vi
Vi
Vi
Vi
Vi
Vi
Vi
Vi
Vi
Vi
Vi
Vi
Vi
lJ
UM
XD
XD
UM
lJ
UM
UM
UM
Vi
Vi
Vi
Vi
Vi
Vi
Vi
Vi
Vi
Vi
Vi
Vi
Vi
Vi
"}
(16,1,1) = {"
Vi
Vi
Vi
Vi
Vi
Vi
Vi
Vi
Vi
Vi
Vi
Vi
Vi
Vi
Vi
Vi
Vi
lJ
uc
QF
QF
uc
lJ
UM
UM
Vi
Vi
Vi
Vi
Vi
Vi
Vi
Vi
Vi
Vi
Vi
Vi
Vi
Vi
Vi
"}
(17,1,1) = {"
Vi
Vi
Vi
Vi
Vi
Vi
Vi
Vi
Vi
Vi
Vi
Vi
Vi
Vi
Vi
Vi
Vi
lJ
ia
PB
PB
ia
lJ
UM
UM
Vi
Vi
Vi
Vi
Vi
Vi
Vi
Vi
Vi
Vi
Vi
Vi
Vi
Vi
Vi
"}
(18,1,1) = {"
Vi
Vi
Vi
Vi
Vi
Vi
Vi
Vi
Vi
Vi
Vi
Vi
Vi
Vi
Vi
Vi
Vi
Vi
Vi
Vi
Vi
Vi
Vi
Vi
Vi
Vi
Vi
Vi
Vi
Vi
Vi
Vi
Vi
Vi
Vi
Vi
Vi
Vi
Vi
Vi
"}
(19,1,1) = {"
Vi
Vi
Vi
Vi
Vi
Vi
Vi
Vi
Vi
Vi
Vi
Vi
Vi
Vi
Vi
Vi
Vi
Vi
Vi
Vi
Vi
Vi
Vi
Vi
Vi
Vi
Vi
Vi
Vi
Vi
Vi
Vi
Vi
Vi
Vi
Vi
Vi
Vi
Vi
Vi
"}
(20,1,1) = {"
Vi
Vi
Vi
Vi
Vi
Vi
Vi
Vi
Vi
Vi
Vi
Vi
Vi
Vi
Vi
Vi
Vi
Vi
Vi
Vi
Vi
Vi
Vi
Vi
Vi
Vi
Vi
Vi
Vi
Vi
Vi
Vi
Vi
Vi
Vi
Vi
Vi
Vi
Vi
Vi
"}
(21,1,1) = {"
Vi
Vi
Vi
Vi
Vi
Vi
Vi
Vi
Vi
Vi
Vi
Vi
Vi
Vi
Vi
Vi
Vi
Vi
Vi
Vi
Vi
Vi
Vi
Vi
Vi
Vi
Vi
Vi
Vi
Vi
Vi
Vi
Vi
Vi
Vi
Vi
Vi
Vi
Vi
Vi
"}
(22,1,1) = {"
Vi
Vi
Vi
Vi
Vi
Vi
Vi
Vi
Vi
Vi
Vi
Vi
Vi
Vi
Vi
Vi
Vi
Vi
Vi
Vi
Vi
Vi
Vi
Vi
Vi
Vi
Vi
Vi
Vi
Vi
Vi
Vi
Vi
Vi
Vi
Vi
Vi
Vi
Vi
Vi
"}
(23,1,1) = {"
Vi
Vi
Vi
Vi
Vi
Vi
Vi
Vi
Vi
Vi
Vi
Vi
Vi
Vi
Vi
Vi
Vi
Vi
Vi
Vi
Vi
Vi
Vi
Vi
Vi
Vi
Vi
Vi
Vi
Vi
Vi
Vi
Vi
Vi
Vi
Vi
Vi
Vi
Vi
Vi
"}
(24,1,1) = {"
Vi
Vi
Vi
Vi
Vi
Vi
Vi
Vi
Vi
Vi
Vi
Vi
Vi
Vi
Vi
Vi
Vi
Vi
Vi
Vi
Vi
Vi
Vi
Vi
Vi
Vi
Vi
Vi
Vi
Vi
Vi
Vi
Vi
Vi
Vi
Vi
Vi
Vi
Vi
Vi
"}
(25,1,1) = {"
Vi
Vi
Vi
Vi
Vi
Vi
Vi
Vi
Vi
Vi
Vi
Vi
Vi
Vi
Vi
Vi
Vi
Vi
Vi
Vi
Vi
Vi
Vi
Vi
Vi
Vi
Vi
Vi
Vi
Vi
Vi
Vi
Vi
Vi
Vi
Vi
Vi
Vi
Vi
Vi
"}
(26,1,1) = {"
Vi
Vi
Vi
Vi
Vi
Vi
Vi
Vi
Vi
Vi
Vi
Vi
Vi
Vi
Vi
Vi
Vi
Vi
Vi
Vi
Vi
Vi
Vi
Vi
Vi
Vi
Vi
Vi
Vi
Vi
Vi
Vi
Vi
Vi
Vi
Vi
Vi
Vi
Vi
Vi
"}
(27,1,1) = {"
Vi
Vi
Vi
Vi
Vi
Vi
Vi
Vi
Vi
Vi
Vi
Vi
Vi
Vi
Vi
Vi
Vi
Vi
Vi
Vi
Vi
Vi
Vi
Vi
Vi
Vi
Vi
Vi
Vi
Vi
Vi
Vi
Vi
Vi
Vi
Vi
Vi
Vi
Vi
Vi
"}
(28,1,1) = {"
Vi
Vi
Vi
Vi
Vi
Vi
Vi
Vi
Vi
Vi
Vi
Vi
Vi
Vi
Vi
Vi
Vi
Vi
Vi
Vi
Vi
Vi
Vi
Vi
Vi
Vi
Vi
Vi
Vi
Vi
Vi
Vi
Vi
Vi
Vi
Vi
Vi
Vi
Vi
Vi
"}
(29,1,1) = {"
Vi
Vi
Vi
Vi
Vi
Vi
Vi
Vi
Vi
Vi
Vi
Vi
Vi
Vi
Vi
Vi
Vi
Vi
Vi
Vi
Vi
Vi
Vi
Vi
Vi
Vi
Vi
Vi
Vi
Vi
Vi
Vi
Vi
Vi
Vi
Vi
Vi
Vi
Vi
Vi
"}
(30,1,1) = {"
Vi
Vi
Vi
Vi
Vi
Vi
Vi
Vi
Vi
Vi
Vi
Vi
Vi
Vi
Vi
Vi
Vi
Vi
Vi
Vi
Vi
Vi
Vi
Vi
Vi
Vi
Vi
Vi
Vi
Vi
Vi
Vi
Vi
Vi
Vi
Vi
Vi
Vi
Vi
Vi
"}
(31,1,1) = {"
Vi
Vi
Vi
Vi
Vi
Vi
Vi
Vi
Vi
Vi
Vi
Vi
Vi
Vi
Vi
Vi
Vi
Vi
Vi
Vi
Vi
Vi
Vi
Vi
Vi
Vi
Vi
Vi
Vi
Vi
Vi
Vi
Vi
Vi
Vi
Vi
Vi
Vi
Vi
Vi
"}
(32,1,1) = {"
Vi
Vi
Vi
Vi
Vi
Vi
Vi
Vi
Vi
Vi
Vi
Vi
Vi
Vi
Vi
Vi
Vi
Vi
Vi
Vi
Vi
Vi
Vi
Vi
Vi
Vi
Vi
Vi
Vi
Vi
Vi
Vi
Vi
Vi
Vi
Vi
Vi
Vi
Vi
Vi
"}
(33,1,1) = {"
Vi
Vi
Vi
Vi
Vi
Vi
Vi
Vi
Vi
Vi
Vi
Vi
Vi
Vi
Vi
Vi
Vi
Vi
Vi
Vi
Vi
Vi
Vi
Vi
Vi
Vi
Vi
Vi
Vi
Vi
Vi
Vi
Vi
Vi
Vi
Vi
Vi
Vi
Vi
Vi
"}
(34,1,1) = {"
Vi
Vi
Vi
Vi
Vi
Vi
Vi
Vi
Vi
Vi
Vi
Vi
Vi
Vi
Vi
Vi
Vi
Vi
Vi
Vi
Vi
Vi
Vi
Vi
Vi
Vi
Vi
Vi
Vi
Vi
Vi
Vi
Vi
Vi
Vi
Vi
Vi
Vi
Vi
Vi
"}
(35,1,1) = {"
Vi
Vi
Vi
Vi
Vi
Vi
Vi
Vi
Vi
Vi
Vi
Vi
Vi
Vi
Vi
Vi
Vi
Vi
Vi
Vi
Vi
Vi
Vi
Vi
Vi
Vi
Vi
Vi
Vi
Vi
Vi
Vi
Vi
Vi
Vi
Vi
Vi
Vi
Vi
Vi
"}
(36,1,1) = {"
Vi
Vi
Vi
Vi
Vi
Vi
Vi
Vi
Vi
Vi
Vi
Vi
Vi
Vi
Vi
Vi
Vi
Vi
Vi
Vi
Vi
Vi
Vi
Vi
Vi
Vi
Vi
Vi
Vi
Vi
Vi
Vi
Vi
Vi
Vi
Vi
Vi
Vi
Vi
Vi
"}
(37,1,1) = {"
Vi
Vi
Vi
Vi
Vi
Vi
Vi
Vi
Vi
Vi
Vi
Vi
Vi
Vi
Vi
Vi
Vi
Vi
Vi
Vi
Vi
Vi
Vi
Vi
Vi
Vi
Vi
Vi
Vi
Vi
Vi
Vi
Vi
Vi
Vi
Vi
Vi
Vi
Vi
Vi
"}
(38,1,1) = {"
Vi
Vi
Vi
Vi
Vi
Vi
Vi
Vi
Vi
Vi
Vi
Vi
Vi
Vi
Vi
Vi
Vi
Vi
Vi
Vi
Vi
Vi
Vi
Vi
Vi
Vi
Vi
Vi
Vi
Vi
Vi
Vi
Vi
Vi
Vi
Vi
Vi
Vi
Vi
Vi
"}
(39,1,1) = {"
Vi
Vi
Vi
Vi
Vi
Vi
Vi
Vi
Vi
Vi
Vi
Vi
Vi
Vi
Vi
Vi
Vi
Vi
Vi
Vi
Vi
Vi
Vi
Vi
Vi
Vi
Vi
Vi
Vi
Vi
Vi
Vi
Vi
Vi
Vi
Vi
Vi
Vi
Vi
Vi
"}
(40,1,1) = {"
Vi
Vi
Vi
Vi
Vi
Vi
Vi
Vi
Vi
Vi
Vi
Vi
Vi
Vi
Vi
Vi
Vi
Vi
Vi
Vi
Vi
Vi
Vi
Vi
Vi
Vi
Vi
Vi
Vi
Vi
Vi
Vi
Vi
Vi
Vi
Vi
Vi
Vi
Vi
Vi
"}
