//MAP CONVERTED BY dmm2tgm.py THIS HEADER COMMENT PREVENTS RECONVERSION, DO NOT REMOVE
"a" = (
/turf/template_noop,
/area/template_noop)
"c" = (
/obj/effect/turf_decal/syndicateemblem/bottom/middle,
/obj/item/stack/rods/ten,
/obj/effect/decal/cleanable/dirt/dust,
/turf/open/floor/mineral/plastitanium/red,
/area/taeloth)
"e" = (
/obj/item/clothing/head/cone,
/turf/open/misc/dirt/jungle,
/area/taeloth)
"f" = (
/obj/effect/decal/cleanable/dirt,
/obj/effect/turf_decal/weather/dirt,
/obj/effect/turf_decal/weather/dirt{
	dir = 1
	},
/turf/open/floor/plating/rust,
/area/taeloth)
"g" = (
/obj/effect/decal/cleanable/dirt,
/obj/structure/cable,
/obj/effect/turf_decal/weather/dirt{
	dir = 4
	},
/turf/open/floor/plating/rust,
/area/taeloth)
"h" = (
/obj/effect/turf_decal/weather/dirt{
	dir = 1
	},
/obj/effect/decal/cleanable/dirt/dust,
/obj/structure/closet/crate/trashcart/laundry,
/obj/item/clothing/under/rank/prisoner/skirt/syndicate,
/obj/item/clothing/under/rank/prisoner/skirt/syndicate,
/obj/item/clothing/under/rank/prisoner/syndicate,
/obj/item/clothing/under/rank/prisoner/syndicate,
/obj/effect/spawner/random/clothing/syndie,
/obj/effect/spawner/random/clothing/syndie,
/obj/item/clothing/under/syndicate/skyrat/tactical/skirt,
/obj/item/clothing/under/syndicate/skyrat/tactical,
/obj/item/clothing/under/rank/cargo/qm/skyrat/syndie,
/turf/open/floor/plating/rust,
/area/taeloth)
"i" = (
/obj/effect/turf_decal/weather/dirt{
	dir = 4
	},
/turf/open/floor/mineral/plastitanium,
/area/taeloth)
"j" = (
/obj/effect/decal/cleanable/dirt/dust,
/turf/open/floor/mineral/plastitanium/red,
/area/taeloth)
"k" = (
/obj/effect/decal/cleanable/dirt,
/obj/effect/turf_decal/weather/dirt{
	dir = 1
	},
/turf/open/floor/plating/rust,
/area/taeloth)
"l" = (
/obj/effect/turf_decal/syndicateemblem/top/middle,
/obj/effect/decal/cleanable/dirt/dust,
/turf/open/floor/mineral/plastitanium/red,
/area/taeloth)
"o" = (
/obj/effect/turf_decal/syndicateemblem/middle/right,
/obj/effect/turf_decal/deep_space_three/right,
/obj/structure/cable,
/turf/open/floor/mineral/plastitanium/red,
/area/taeloth)
"p" = (
/obj/effect/decal/cleanable/dirt,
/obj/effect/decal/cleanable/dirt/dust,
/turf/open/floor/mineral/plastitanium/red,
/area/taeloth)
"r" = (
/obj/effect/decal/cleanable/dirt,
/obj/structure/cable,
/turf/open/floor/mineral/plastitanium,
/area/taeloth)
"s" = (
/obj/effect/spawner/structure/window/reinforced/plasma/plastitanium,
/obj/effect/mapping_helpers/damaged_window,
/turf/open/floor/plating,
/area/taeloth)
"t" = (
/obj/structure/sign/warning/secure_area/directional/west,
/turf/open/misc/dirt/jungle,
/area/taeloth)
"u" = (
/obj/effect/decal/cleanable/dirt,
/obj/structure/cable,
/obj/effect/decal/cleanable/dirt/dust,
/turf/open/floor/plating/rust,
/area/taeloth)
"w" = (
/turf/open/misc/dirt/jungle,
/area/taeloth)
"x" = (
/obj/effect/decal/cleanable/dirt,
/obj/machinery/power/floodlight,
/obj/structure/cable,
/turf/open/floor/plating/rust,
/area/taeloth)
"y" = (
/obj/effect/turf_decal/syndicateemblem/bottom/left,
/obj/effect/decal/cleanable/dirt,
/obj/effect/decal/cleanable/dirt/dust,
/turf/open/floor/mineral/plastitanium/red,
/area/taeloth)
"z" = (
/obj/effect/turf_decal/syndicateemblem/top/right,
/obj/effect/decal/cleanable/dirt,
/obj/effect/decal/cleanable/dirt,
/turf/open/floor/mineral/plastitanium/red,
/area/taeloth)
"A" = (
/obj/effect/decal/cleanable/dirt,
/obj/effect/turf_decal/weather/dirt{
	dir = 6
	},
/turf/open/floor/plating/rust,
/area/taeloth)
"B" = (
/obj/effect/turf_decal/syndicateemblem/top/left,
/obj/effect/decal/cleanable/dirt,
/obj/item/storage/toolbox/mechanical,
/obj/effect/decal/cleanable/dirt/dust,
/turf/open/floor/mineral/plastitanium/red,
/area/taeloth)
"C" = (
/turf/closed/wall/mineral/plastitanium/nodiagonal,
/area/taeloth)
"D" = (
/obj/effect/turf_decal/syndicateemblem/bottom/right,
/obj/structure/cable,
/obj/effect/decal/cleanable/dirt/dust,
/turf/open/floor/mineral/plastitanium/red,
/area/taeloth)
"E" = (
/obj/effect/decal/cleanable/dirt,
/obj/effect/decal/cleanable/dirt,
/obj/structure/closet/crate/trashcart,
/turf/open/floor/mineral/plastitanium/red,
/area/taeloth)
"F" = (
/obj/effect/decal/cleanable/dirt,
/turf/open/floor/plating/rust,
/area/taeloth)
"J" = (
/obj/effect/decal/cleanable/dirt,
/obj/effect/turf_decal/weather/dirt{
	dir = 6
	},
/obj/effect/turf_decal/weather/dirt{
	dir = 1
	},
/turf/open/floor/plating/rust,
/area/taeloth)
"K" = (
/obj/machinery/power/port_gen/pacman,
/obj/structure/cable,
/turf/open/misc/dirt/jungle,
/area/taeloth)
"L" = (
/obj/effect/turf_decal/syndicateemblem/middle/left,
/obj/effect/turf_decal/deep_space_three/left,
/obj/effect/decal/cleanable/dirt,
/obj/structure/cable,
/turf/open/floor/mineral/plastitanium/red,
/area/taeloth)
"M" = (
/obj/effect/decal/cleanable/dirt,
/obj/effect/turf_decal/weather/dirt,
/turf/open/floor/plating/rust,
/area/taeloth)
"N" = (
/obj/effect/decal/cleanable/dirt,
/obj/effect/turf_decal/weather/dirt{
	dir = 9
	},
/obj/effect/turf_decal/weather/dirt{
	dir = 4
	},
/turf/open/floor/plating/rust,
/area/taeloth)
"O" = (
/obj/structure/sign/poster/official/nanotrasen_logo/directional/north,
/obj/effect/decal/cleanable/dirt/dust,
/turf/open/floor/mineral/plastitanium,
/area/taeloth)
"P" = (
/turf/open/floor/mineral/plastitanium,
/area/taeloth)
"R" = (
/obj/structure/grille/broken,
/obj/effect/decal/cleanable/dirt,
/obj/effect/turf_decal/weather/dirt,
/turf/open/floor/plating/rust,
/area/taeloth)
"T" = (
/obj/effect/decal/cleanable/dirt,
/obj/effect/turf_decal/weather/dirt{
	dir = 10
	},
/turf/open/floor/plating/rust,
/area/taeloth)
"U" = (
/obj/effect/spawner/random/structure/billboard/nanotrasen,
/turf/open/misc/dirt/jungle,
/area/taeloth)
"V" = (
/obj/structure/cable,
/turf/open/misc/dirt/jungle,
/area/taeloth)
"W" = (
/obj/structure/railing,
/obj/effect/decal/cleanable/dirt,
/turf/open/floor/mineral/plastitanium/red,
/area/taeloth)
"X" = (
/obj/effect/turf_decal/syndicateemblem/middle/middle,
/obj/effect/turf_decal/deep_space_three,
/obj/structure/cable,
/turf/open/floor/mineral/plastitanium/red,
/area/taeloth)
"Z" = (
/obj/effect/decal/cleanable/dirt,
/obj/effect/decal/cleanable/dirt/dust,
/turf/open/floor/mineral/plastitanium,
/area/taeloth)

(1,1,1) = {"
a
a
a
a
a
a
w
w
w
a
"}
(2,1,1) = {"
a
a
w
a
a
e
w
w
U
w
"}
(3,1,1) = {"
a
a
w
w
f
V
w
w
w
w
"}
(4,1,1) = {"
a
w
w
C
Z
u
P
C
w
w
"}
(5,1,1) = {"
a
w
C
C
O
r
F
s
w
e
"}
(6,1,1) = {"
w
w
k
F
B
L
y
W
T
w
"}
(7,1,1) = {"
w
N
Z
p
l
X
c
j
M
a
"}
(8,1,1) = {"
w
w
h
E
z
o
D
x
A
a
"}
(9,1,1) = {"
a
w
C
C
F
r
Z
R
a
a
"}
(10,1,1) = {"
a
w
w
C
i
g
Z
C
a
a
"}
(11,1,1) = {"
a
e
w
w
V
V
J
t
a
a
"}
(12,1,1) = {"
a
a
a
w
K
w
w
a
a
a
"}
(13,1,1) = {"
a
a
a
a
a
a
a
a
a
a
"}
