//MAP CONVERTED BY dmm2tgm.py THIS HEADER COMMENT PREVENTS RECONVERSION, DO NOT REMOVE
"a" = (
/obj/structure/cable,
/obj/machinery/atmospherics/pipe/smart/manifold4w/supply/hidden/layer4,
/obj/machinery/atmospherics/pipe/smart/manifold4w/scrubbers/hidden/layer2,
/obj/effect/decal/cleanable/dirt,
/turf/open/floor/iron/small,
/area/station/commons/cryo)
"c" = (
/turf/closed/wall,
/area/station/commons/cryo)
"m" = (
/obj/effect/turf_decal/siding/thinplating_new/light/end,
/obj/effect/decal/cleanable/dirt,
/obj/machinery/cryopod{
	dir = 4
	},
/turf/open/floor/iron/dark,
/area/station/commons/cryo)
"n" = (
/obj/structure/cable,
/obj/machinery/atmospherics/pipe/smart/manifold4w/scrubbers/hidden/layer2,
/obj/effect/decal/cleanable/dirt,
/turf/open/floor/iron/small,
/area/station/commons/cryo)
"p" = (
/obj/structure/sign/poster/official/random/directional/north,
/obj/effect/decal/cleanable/dirt,
/obj/machinery/vending/clothing,
/turf/open/floor/iron/small,
/area/station/commons/cryo)
"s" = (
/obj/effect/spawner/structure/window,
/turf/open/floor/plating,
/area/station/commons/cryo)
"v" = (
/obj/structure/sign/poster/official/random/directional/north,
/obj/effect/decal/cleanable/dirt,
/obj/machinery/vending/dorms,
/turf/open/floor/iron/small,
/area/station/commons/cryo)
"x" = (
/obj/structure/cable,
/obj/machinery/atmospherics/pipe/smart/manifold4w/supply/hidden/layer4,
/obj/machinery/atmospherics/pipe/smart/manifold4w/scrubbers/hidden/layer2,
/obj/effect/mapping_helpers/broken_floor,
/obj/effect/decal/cleanable/dirt,
/obj/effect/landmark/event_spawn,
/turf/open/floor/iron/small,
/area/station/commons/cryo)
"A" = (
/obj/structure/cable,
/obj/machinery/atmospherics/pipe/smart/manifold4w/supply/hidden/layer4,
/obj/machinery/atmospherics/pipe/smart/manifold4w/scrubbers/hidden/layer2,
/obj/machinery/door/airlock/public{
	name = "Cryopods"
	},
/obj/machinery/door/firedoor,
/turf/open/floor/iron/textured_half,
/area/station/commons/cryo)
"G" = (
/obj/effect/turf_decal/siding/thinplating_new/light/end,
/obj/machinery/cryopod{
	dir = 8
	},
/obj/effect/decal/cleanable/dirt,
/obj/machinery/light/directional/south,
/turf/open/floor/iron/dark,
/area/station/commons/cryo)
"K" = (
/obj/effect/turf_decal/siding/thinplating_new/light{
	dir = 4
	},
/obj/machinery/cryopod{
	dir = 8
	},
/obj/machinery/atmospherics/pipe/smart/manifold4w/supply/hidden/layer4,
/obj/effect/turf_decal/siding/thinplating_new/light{
	dir = 8
	},
/obj/effect/decal/cleanable/dirt,
/turf/open/floor/iron/dark,
/area/station/commons/cryo)
"M" = (
/obj/effect/turf_decal/siding/thinplating_new/light/end{
	dir = 1
	},
/obj/machinery/cryopod{
	dir = 8
	},
/obj/machinery/atmospherics/pipe/smart/manifold4w/supply/hidden/layer4,
/obj/effect/decal/cleanable/dirt,
/obj/machinery/firealarm/directional/east,
/turf/open/floor/iron/dark,
/area/station/commons/cryo)
"Q" = (
/obj/structure/cable,
/obj/effect/decal/cleanable/dirt,
/obj/machinery/atmospherics/components/unary/vent_scrubber/on/layer2,
/turf/open/floor/iron/small,
/area/station/commons/cryo)
"R" = (
/obj/effect/decal/cleanable/dirt,
/obj/machinery/camera/autoname/directional/west,
/obj/machinery/power/apc/auto_name/directional/west,
/obj/structure/cable,
/obj/structure/broken_flooring/corner/directional/south,
/turf/open/floor/plating/rust,
/area/station/commons/cryo)
"S" = (
/obj/effect/turf_decal/siding/thinplating_new/light{
	dir = 8
	},
/obj/effect/decal/cleanable/dirt,
/obj/machinery/cryopod{
	dir = 4
	},
/obj/effect/turf_decal/siding/thinplating_new/light{
	dir = 4
	},
/turf/open/floor/iron/dark,
/area/station/commons/cryo)
"U" = (
/obj/effect/turf_decal/siding/thinplating_new/light/end{
	dir = 1
	},
/obj/machinery/cryopod{
	dir = 4
	},
/obj/effect/decal/cleanable/dirt,
/turf/open/floor/iron/dark,
/area/station/commons/cryo)
"V" = (
/obj/effect/decal/cleanable/dirt,
/obj/effect/turf_decal/siding/thinplating_new/light/end,
/obj/machinery/light/directional/north,
/obj/machinery/computer/cryopod/directional/north,
/turf/open/floor/iron/dark,
/area/station/commons/cryo)
"Y" = (
/obj/effect/mapping_helpers/broken_floor,
/obj/effect/decal/cleanable/dirt,
/obj/machinery/atmospherics/components/unary/vent_pump/on/layer4,
/obj/machinery/airalarm/directional/east,
/turf/open/floor/iron/small,
/area/station/commons/cryo)

(1,1,1) = {"
c
c
c
c
c
c
c
"}
(2,1,1) = {"
c
v
R
U
S
m
s
"}
(3,1,1) = {"
c
V
Q
n
x
a
A
"}
(4,1,1) = {"
c
p
Y
M
K
G
c
"}
(5,1,1) = {"
c
c
c
c
c
c
c
"}
