//MAP CONVERTED BY dmm2tgm.py THIS HEADER COMMENT PREVENTS RECONVERSION, DO NOT REMOVE
"am" = (
/obj/structure/fluff/broken_flooring{
	icon_state = "plating"
	},
/obj/machinery/firealarm/directional/east,
/obj/effect/decal/cleanable/dirt/dust,
/turf/open/floor/iron,
/area/station/service/broadcast_centre)
"br" = (
/obj/structure/cable,
/obj/structure/disposalpipe/segment,
/obj/effect/mapping_helpers/broken_floor,
/obj/machinery/atmospherics/pipe/smart/manifold4w/supply/hidden/layer4,
/obj/machinery/atmospherics/pipe/smart/manifold4w/scrubbers/hidden/layer2,
/turf/open/floor/iron,
/area/station/maintenance/hallway/abandoned_recreation)
"bB" = (
/obj/effect/mapping_helpers/burnt_floor,
/obj/structure/fluff/broken_flooring{
	dir = 4;
	icon_state = "singular"
	},
/obj/effect/decal/cleanable/dirt/dust,
/turf/open/floor/plating,
/area/station/service/broadcast_centre)
"bQ" = (
/obj/machinery/atmospherics/components/unary/vent_scrubber/on/layer2{
	dir = 8
	},
/obj/effect/decal/cleanable/dirt/dust,
/turf/open/floor/plating,
/area/station/service/broadcast_centre)
"cC" = (
/obj/effect/mapping_helpers/broken_floor,
/obj/machinery/rnd/production/circuit_imprinter,
/obj/machinery/light/small/directional/east,
/turf/open/floor/iron,
/area/station/service/broadcast_centre)
"ek" = (
/obj/effect/mapping_helpers/broken_floor,
/obj/machinery/atmospherics/pipe/smart/manifold4w/supply/hidden/layer4,
/obj/effect/decal/cleanable/dirt/dust,
/turf/open/floor/iron,
/area/station/service/broadcast_centre)
"eR" = (
/obj/structure/cable,
/obj/structure/disposalpipe/segment{
	dir = 6
	},
/obj/effect/decal/cleanable/dirt/dust,
/obj/machinery/atmospherics/pipe/smart/manifold4w/supply/hidden/layer4,
/obj/machinery/atmospherics/pipe/smart/manifold4w/scrubbers/hidden/layer2,
/turf/open/floor/iron,
/area/station/maintenance/hallway/abandoned_recreation)
"fy" = (
/obj/item/stack/tile/iron,
/obj/effect/mapping_helpers/broken_floor,
/turf/open/floor/plating,
/area/station/service/broadcast_centre)
"fC" = (
/obj/structure/cable,
/obj/machinery/camera/autoname/directional/west{
	dir = 10
	},
/obj/machinery/atmospherics/pipe/smart/manifold4w/supply/hidden/layer4,
/obj/machinery/atmospherics/pipe/smart/manifold4w/scrubbers/hidden/layer2,
/turf/open/floor/iron,
/area/station/service/broadcast_centre)
"fL" = (
/obj/effect/turf_decal/siding/white,
/turf/open/floor/iron,
/area/station/service/broadcast_centre)
"gS" = (
/obj/machinery/button/door/directional/south{
	normaldoorcontrol = 1;
	specialfunctions = 4;
	id = "dressingroombolts";
	name = "Bolt Control"
	},
/obj/effect/mapping_helpers/broken_floor,
/obj/effect/decal/cleanable/dirt/dust,
/turf/open/floor/wood,
/area/station/service/broadcast_centre)
"hs" = (
/obj/effect/decal/cleanable/glass,
/obj/structure/fluff/broken_flooring{
	icon_state = "plating";
	dir = 8
	},
/turf/open/floor/iron,
/area/station/service/broadcast_centre)
"hG" = (
/obj/structure/fluff/broken_flooring{
	icon_state = "singular"
	},
/obj/effect/decal/cleanable/dirt/dust,
/turf/open/floor/plating,
/area/station/service/broadcast_centre)
"hS" = (
/obj/effect/landmark/atmospheric_sanity/ignore_area,
/turf/open/floor/iron,
/area/station/service/broadcast_centre/stage)
"ie" = (
/obj/machinery/computer/camera_advanced/base_construction/broadcast{
	dir = 1
	},
/obj/structure/cable,
/obj/machinery/atmospherics/pipe/smart/manifold4w/supply/hidden/layer4,
/obj/effect/decal/cleanable/dirt/dust,
/turf/open/floor/iron,
/area/station/service/broadcast_centre)
"jW" = (
/obj/machinery/vending/autodrobe,
/obj/machinery/light/small/directional/north,
/turf/open/floor/plating,
/area/station/service/broadcast_centre)
"kT" = (
/obj/machinery/atmospherics/components/unary/vent_pump/on/layer4,
/turf/open/floor/iron,
/area/station/service/broadcast_centre)
"kZ" = (
/obj/structure/cable,
/obj/effect/mapping_helpers/broken_floor,
/obj/machinery/atmospherics/pipe/smart/manifold4w/supply/hidden/layer4,
/obj/machinery/atmospherics/pipe/smart/manifold4w/scrubbers/hidden/layer2,
/turf/open/floor/plating,
/area/station/maintenance/hallway/abandoned_recreation)
"lz" = (
/obj/machinery/door/firedoor,
/obj/effect/decal/cleanable/dirt/dust,
/turf/open/floor/iron,
/area/station/service/broadcast_centre)
"mx" = (
/obj/structure/fluff/broken_flooring{
	icon_state = "plating";
	dir = 8
	},
/obj/effect/decal/cleanable/dirt/dust,
/obj/structure/chair/plastic,
/obj/effect/landmark/start/broadcast_team,
/turf/open/floor/iron,
/area/station/service/broadcast_centre)
"mL" = (
/obj/machinery/door/firedoor,
/obj/machinery/door/airlock/public{
	name = "Upper Domiciles"
	},
/turf/open/floor/plating,
/area/station/maintenance/hallway/abandoned_recreation)
"ox" = (
/obj/structure/table,
/obj/machinery/computer/security/telescreen/broadcast_team{
	dir = 4;
	pixel_y = 3
	},
/turf/open/floor/plating,
/area/station/service/broadcast_centre)
"pN" = (
/obj/structure/cable,
/obj/machinery/power/apc/auto_name/directional/north,
/obj/machinery/atmospherics/pipe/smart/manifold4w/supply/hidden/layer4,
/turf/open/floor/iron,
/area/station/service/broadcast_centre)
"pY" = (
/obj/effect/mapping_helpers/burnt_floor,
/obj/effect/decal/cleanable/dirt/dust,
/obj/structure/table/wood,
/turf/open/floor/wood,
/area/station/service/broadcast_centre)
"qc" = (
/obj/structure/bed/dogbed,
/obj/effect/mapping_helpers/broken_floor,
/obj/effect/decal/cleanable/dirt/dust,
/turf/open/floor/iron,
/area/station/service/broadcast_centre)
"qe" = (
/obj/effect/mapping_helpers/broken_floor,
/obj/effect/decal/cleanable/dirt/dust,
/obj/effect/landmark/start/broadcast_team,
/turf/open/floor/plating,
/area/station/service/broadcast_centre)
"sZ" = (
/turf/closed/wall,
/area/station/maintenance/starboard/fore)
"tn" = (
/obj/machinery/light/small/directional/north,
/obj/effect/mapping_helpers/broken_floor,
/obj/effect/decal/cleanable/dirt/dust,
/turf/open/floor/plating,
/area/station/service/broadcast_centre)
"tH" = (
/obj/machinery/vending/clothing,
/turf/open/floor/plating,
/area/station/service/broadcast_centre)
"uc" = (
/obj/structure/fluff/broken_flooring{
	dir = 4;
	icon_state = "pile"
	},
/obj/effect/mapping_helpers/burnt_floor,
/obj/structure/cable,
/obj/machinery/atmospherics/pipe/smart/manifold4w/supply/hidden/layer4,
/obj/machinery/atmospherics/pipe/smart/manifold4w/scrubbers/hidden/layer2,
/turf/open/floor/plating,
/area/station/service/broadcast_centre)
"ue" = (
/obj/structure/cable,
/obj/machinery/atmospherics/pipe/smart/manifold4w/supply/hidden/layer4,
/obj/machinery/atmospherics/pipe/smart/manifold4w/scrubbers/hidden/layer2,
/obj/effect/decal/cleanable/dirt/dust,
/obj/effect/landmark/start/broadcast_team,
/turf/open/floor/iron,
/area/station/service/broadcast_centre)
"un" = (
/obj/effect/mapping_helpers/broken_floor,
/turf/open/floor/iron,
/area/station/service/broadcast_centre)
"us" = (
/obj/effect/turf_decal/siding/white,
/obj/effect/mapping_helpers/broken_floor,
/turf/open/floor/iron,
/area/station/service/broadcast_centre)
"uK" = (
/obj/effect/mapping_helpers/burnt_floor,
/obj/item/reagent_containers/cup/bowl,
/turf/open/floor/plating,
/area/station/service/broadcast_centre)
"uO" = (
/obj/effect/mapping_helpers/burnt_floor,
/obj/effect/decal/cleanable/oil/slippery,
/obj/structure/toilet{
	pixel_y = 12
	},
/obj/effect/landmark/start/broadcast_team,
/turf/open/floor/plating,
/area/station/service/broadcast_centre)
"uP" = (
/obj/structure/cable,
/obj/structure/disposalpipe/segment,
/obj/effect/decal/cleanable/dirt/dust,
/obj/machinery/atmospherics/pipe/smart/manifold4w/supply/hidden/layer4,
/obj/machinery/atmospherics/pipe/smart/manifold4w/scrubbers/hidden/layer2,
/turf/open/floor/iron,
/area/station/maintenance/hallway/abandoned_recreation)
"vy" = (
/obj/structure/table,
/obj/machinery/button/showtime/broadcast_team,
/obj/item/reagent_containers/cup/glass/waterbottle{
	pixel_x = 9;
	pixel_y = 3
	},
/obj/structure/cable,
/obj/machinery/atmospherics/pipe/smart/manifold4w/supply/hidden/layer4,
/obj/effect/decal/cleanable/dirt/dust,
/turf/open/floor/iron,
/area/station/service/broadcast_centre)
"vO" = (
/obj/effect/mapping_helpers/broken_floor,
/turf/open/floor/wood,
/area/station/service/broadcast_centre)
"vP" = (
/obj/item/radio/intercom/broadcast/directional/east,
/obj/structure/table,
/turf/open/floor/iron,
/area/station/service/broadcast_centre/stage)
"xy" = (
/obj/machinery/door/airlock/silver{
	name = "Bathroom";
	id_tag = "broadcastbathroom"
	},
/obj/effect/mapping_helpers/broken_floor,
/turf/open/floor/plating,
/area/station/service/broadcast_centre)
"xJ" = (
/obj/machinery/camera/broadcast/directional/south{
	view_range = 4
	},
/turf/open/floor/iron,
/area/station/service/broadcast_centre/stage)
"yc" = (
/obj/effect/mapping_helpers/broken_floor,
/obj/effect/decal/cleanable/dirt/dust,
/obj/structure/mirror/directional/north,
/obj/structure/chair/stool/directional/north,
/obj/effect/landmark/start/broadcast_team,
/turf/open/floor/wood,
/area/station/service/broadcast_centre)
"zq" = (
/obj/effect/turf_decal/siding/white,
/obj/effect/decal/cleanable/dirt/dust,
/turf/open/floor/iron,
/area/station/service/broadcast_centre)
"zH" = (
/obj/effect/landmark/start/broadcast_team,
/turf/open/floor/iron,
/area/station/service/broadcast_centre/stage)
"Ae" = (
/obj/item/radio/intercom/broadcast/directional/west,
/turf/open/floor/iron,
/area/station/service/broadcast_centre/stage)
"Ah" = (
/obj/machinery/camera/autoname/directional/east,
/obj/effect/mapping_helpers/broken_floor,
/obj/effect/decal/cleanable/dirt/dust,
/turf/open/floor/iron,
/area/station/service/broadcast_centre)
"Al" = (
/obj/structure/fluff/broken_flooring{
	icon_state = "plating";
	dir = 8
	},
/obj/machinery/light/small/directional/west,
/obj/effect/decal/cleanable/dirt/dust,
/turf/open/floor/iron,
/area/station/service/broadcast_centre)
"Aw" = (
/obj/effect/turf_decal/siding/white/corner{
	dir = 8
	},
/obj/effect/mapping_helpers/broken_floor,
/turf/open/floor/iron,
/area/station/service/broadcast_centre)
"BL" = (
/obj/effect/mapping_helpers/broken_floor,
/turf/open/floor/plating,
/area/station/service/broadcast_centre)
"Fm" = (
/obj/effect/mapping_helpers/broken_floor,
/obj/effect/decal/cleanable/dirt/dust,
/turf/open/floor/iron,
/area/station/service/broadcast_centre)
"Gi" = (
/obj/structure/cable,
/obj/structure/disposalpipe/segment,
/obj/effect/mapping_helpers/broken_floor,
/obj/effect/decal/cleanable/dirt/dust,
/obj/machinery/atmospherics/pipe/smart/manifold4w/supply/hidden/layer4,
/obj/machinery/atmospherics/pipe/smart/manifold4w/scrubbers/hidden/layer2,
/turf/open/floor/iron,
/area/station/maintenance/hallway/abandoned_recreation)
"Gq" = (
/obj/machinery/autolathe,
/turf/open/floor/iron,
/area/station/service/broadcast_centre)
"Gy" = (
/turf/open/floor/iron,
/area/station/service/broadcast_centre)
"Hw" = (
/obj/machinery/power/floodlight,
/obj/structure/cable,
/obj/machinery/atmospherics/pipe/smart/manifold4w/supply/hidden/layer4,
/obj/effect/decal/cleanable/dirt/dust,
/turf/open/floor/catwalk_floor/iron,
/area/station/service/broadcast_centre)
"HV" = (
/turf/closed/wall,
/area/station/service/broadcast_centre)
"Jq" = (
/obj/effect/mapping_helpers/burnt_floor,
/obj/effect/decal/cleanable/dirt/dust,
/obj/structure/dresser,
/turf/open/floor/wood,
/area/station/service/broadcast_centre)
"Js" = (
/obj/structure/cable,
/obj/structure/disposalpipe/segment,
/obj/effect/decal/cleanable/dirt/dust,
/obj/machinery/atmospherics/pipe/smart/manifold4w/supply/hidden/layer4,
/obj/machinery/atmospherics/pipe/smart/manifold4w/scrubbers/hidden/layer2,
/turf/open/floor/plating,
/area/station/maintenance/hallway/abandoned_recreation)
"JW" = (
/obj/effect/mapping_helpers/broken_floor,
/obj/structure/fluff/broken_flooring{
	dir = 4;
	icon_state = "singular"
	},
/obj/effect/decal/cleanable/oil/streak,
/obj/machinery/light/small/directional/west,
/obj/effect/decal/cleanable/dirt/dust,
/turf/open/floor/plating,
/area/station/service/broadcast_centre)
"Ka" = (
/obj/effect/mapping_helpers/burnt_floor,
/obj/effect/decal/cleanable/dirt/dust,
/obj/structure/frame/machine,
/turf/open/floor/wood,
/area/station/service/broadcast_centre)
"Kb" = (
/obj/item/stack/tile/iron,
/obj/effect/mapping_helpers/burnt_floor,
/obj/structure/cable,
/obj/machinery/atmospherics/pipe/smart/manifold4w/supply/hidden/layer4,
/turf/open/floor/plating,
/area/station/service/broadcast_centre)
"KX" = (
/obj/machinery/door/airlock{
	name = "Actor Dormitory"
	},
/obj/effect/mapping_helpers/burnt_floor,
/obj/effect/decal/cleanable/dirt/dust,
/turf/open/floor/iron,
/area/station/service/broadcast_centre)
"LV" = (
/obj/effect/mapping_helpers/burnt_floor,
/obj/effect/turf_decal/siding/wood{
	dir = 8
	},
/obj/effect/turf_decal/siding/wood{
	dir = 4
	},
/obj/machinery/door/airlock{
	id_tag = "dressingroombolts";
	name = "Dressing Room"
	},
/obj/effect/mapping_helpers/airlock/access/all/service/broadcast_centre,
/obj/effect/mapping_helpers/airlock/unres{
	dir = 8
	},
/turf/open/floor/wood/large,
/area/station/service/broadcast_centre)
"Mz" = (
/obj/machinery/airalarm/directional/east,
/obj/structure/table,
/obj/item/storage/toolbox/mechanical{
	pixel_y = 10;
	pixel_x = 3
	},
/obj/item/storage/toolbox/mechanical{
	pixel_y = 5;
	pixel_x = 2
	},
/obj/item/multitool{
	pixel_x = -4
	},
/obj/item/multitool{
	pixel_x = 2
	},
/turf/open/floor/iron,
/area/station/service/broadcast_centre/stage)
"MY" = (
/obj/effect/mapping_helpers/burnt_floor,
/obj/effect/decal/cleanable/dirt/dust,
/turf/open/floor/wood,
/area/station/service/broadcast_centre)
"NB" = (
/obj/structure/cable,
/obj/structure/disposalpipe/segment{
	dir = 9
	},
/obj/effect/decal/cleanable/dirt/dust,
/obj/effect/turf_decal/tile/neutral{
	dir = 4
	},
/obj/machinery/atmospherics/pipe/smart/manifold4w/supply/hidden/layer4,
/obj/machinery/atmospherics/pipe/smart/manifold4w/scrubbers/hidden/layer2,
/turf/open/floor/iron,
/area/station/hallway/secondary/recreation)
"NH" = (
/obj/structure/cable,
/obj/structure/disposalpipe/segment,
/obj/machinery/door/firedoor,
/obj/machinery/door/airlock/public{
	name = "Upper Domiciles"
	},
/obj/machinery/atmospherics/pipe/smart/manifold4w/supply/hidden/layer4,
/obj/machinery/atmospherics/pipe/smart/manifold4w/scrubbers/hidden/layer2,
/turf/open/floor/iron,
/area/station/maintenance/hallway/abandoned_recreation)
"OL" = (
/obj/effect/mapping_helpers/broken_floor,
/obj/structure/table/wood,
/turf/open/floor/wood,
/area/station/service/broadcast_centre)
"Pk" = (
/obj/structure/cable,
/obj/effect/mapping_helpers/broken_floor,
/obj/machinery/atmospherics/pipe/smart/manifold4w/supply/hidden/layer4,
/obj/machinery/atmospherics/pipe/smart/manifold4w/scrubbers/hidden/layer2,
/obj/machinery/door/airlock/glass_large,
/obj/effect/mapping_helpers/airlock/access/all/service/broadcast_centre,
/obj/effect/mapping_helpers/airlock/autoname,
/turf/open/floor/iron,
/area/station/service/broadcast_centre)
"PR" = (
/turf/template_noop,
/area/template_noop)
"Qw" = (
/obj/effect/mapping_helpers/broken_floor,
/obj/structure/cable,
/obj/machinery/atmospherics/pipe/smart/manifold4w/supply/hidden/layer4,
/obj/machinery/atmospherics/pipe/smart/manifold4w/scrubbers/hidden/layer2,
/obj/effect/decal/cleanable/dirt/dust,
/turf/open/floor/iron,
/area/station/service/broadcast_centre)
"Qz" = (
/turf/open/floor/iron,
/area/station/service/broadcast_centre/stage)
"SA" = (
/obj/effect/mapping_helpers/broken_floor,
/obj/structure/cable,
/obj/machinery/atmospherics/pipe/smart/manifold4w/supply/hidden/layer4,
/obj/effect/decal/cleanable/dirt/dust,
/turf/open/floor/iron,
/area/station/service/broadcast_centre)
"SH" = (
/obj/effect/mapping_helpers/broken_floor,
/obj/machinery/shower/directional/south,
/obj/structure/drain,
/turf/open/floor/plating,
/area/station/service/broadcast_centre)
"Ud" = (
/obj/structure/cable,
/obj/effect/decal/cleanable/dirt/dust,
/obj/machinery/atmospherics/pipe/smart/manifold4w/supply/hidden/layer4,
/obj/machinery/atmospherics/pipe/smart/manifold4w/scrubbers/hidden/layer2,
/turf/open/floor/iron,
/area/station/maintenance/hallway/abandoned_recreation)
"VT" = (
/obj/effect/decal/cleanable/dirt/dust,
/turf/open/floor/catwalk_floor/iron,
/area/station/service/broadcast_centre)
"VW" = (
/obj/item/shard,
/obj/machinery/door/firedoor,
/obj/effect/decal/cleanable/dirt/dust,
/turf/open/floor/iron,
/area/station/service/broadcast_centre)
"WA" = (
/obj/effect/spawner/structure/window/hollow/directional{
	dir = 4
	},
/obj/effect/decal/cleanable/glass,
/turf/open/floor/plating,
/area/station/service/broadcast_centre)
"Xg" = (
/obj/effect/decal/cleanable/dirt/dust,
/turf/open/floor/iron,
/area/station/service/broadcast_centre)
"Xh" = (
/obj/effect/mapping_helpers/burnt_floor,
/obj/effect/decal/cleanable/dirt/dust,
/obj/structure/safe/floor,
/obj/item/vending_refill/lustwish,
/obj/item/stack/cable_coil/five,
/turf/open/floor/wood,
/area/station/service/broadcast_centre)
"Yd" = (
/obj/structure/cable,
/obj/machinery/atmospherics/pipe/smart/manifold4w/supply/hidden/layer4,
/turf/open/floor/iron,
/area/station/service/broadcast_centre)
"YJ" = (
/obj/effect/mapping_helpers/broken_floor,
/obj/machinery/button/door/directional/south{
	normaldoorcontrol = 1;
	specialfunctions = 4;
	id = "broadcastbathroom";
	name = "Bolt Control"
	},
/obj/structure/sink/kitchen/directional/west,
/obj/structure/mirror/directional/east,
/obj/effect/decal/cleanable/dirt/dust,
/turf/open/floor/plating,
/area/station/service/broadcast_centre)
"YP" = (
/obj/effect/mapping_helpers/broken_floor,
/obj/machinery/light/small/directional/east,
/turf/open/floor/iron,
/area/station/service/broadcast_centre)
"YY" = (
/turf/closed/wall,
/area/station/maintenance/fore/greater)

(1,1,1) = {"
HV
HV
HV
HV
YY
PR
PR
PR
PR
PR
PR
PR
PR
PR
PR
PR
PR
PR
PR
PR
PR
PR
"}
(2,1,1) = {"
HV
pY
OL
Ka
YY
YY
PR
PR
PR
PR
PR
PR
PR
PR
PR
PR
PR
PR
PR
PR
PR
PR
"}
(3,1,1) = {"
HV
Jq
Xh
vO
gS
YY
PR
PR
PR
PR
PR
PR
PR
PR
PR
PR
PR
PR
PR
PR
PR
PR
"}
(4,1,1) = {"
HV
yc
MY
HV
LV
YY
YY
YY
YY
YY
YY
YY
PR
PR
PR
PR
PR
PR
PR
PR
PR
PR
"}
(5,1,1) = {"
HV
HV
HV
HV
tn
lz
Yd
uc
Qw
ue
fC
Pk
kZ
Ud
eR
Gi
uP
Gi
Js
br
NH
NB
"}
(6,1,1) = {"
HV
SH
JW
xy
hs
VW
Kb
bQ
am
YP
un
Fm
PR
PR
PR
PR
PR
PR
PR
PR
mL
PR
"}
(7,1,1) = {"
HV
uO
YJ
HV
WA
HV
pN
BL
HV
HV
HV
HV
HV
sZ
PR
PR
PR
PR
PR
PR
PR
PR
"}
(8,1,1) = {"
HV
HV
HV
HV
BL
Gy
SA
zq
hS
Qz
Ae
Qz
Qz
sZ
PR
PR
PR
PR
PR
PR
PR
PR
"}
(9,1,1) = {"
PR
PR
HV
jW
hG
ox
vy
zq
Qz
Qz
Qz
zH
Qz
sZ
PR
PR
PR
PR
PR
PR
PR
PR
"}
(10,1,1) = {"
PR
PR
HV
tH
BL
mx
ie
us
Qz
zH
Qz
Qz
xJ
sZ
PR
PR
PR
PR
PR
PR
PR
PR
"}
(11,1,1) = {"
PR
PR
HV
HV
HV
VT
Hw
fL
Qz
Qz
Qz
zH
Qz
sZ
PR
PR
PR
PR
PR
PR
PR
PR
"}
(12,1,1) = {"
PR
PR
PR
HV
Gq
kT
ek
fL
Qz
Mz
vP
Qz
Qz
sZ
PR
PR
PR
PR
PR
PR
PR
PR
"}
(13,1,1) = {"
PR
PR
PR
HV
cC
Ah
Xg
Aw
HV
HV
HV
HV
HV
sZ
PR
PR
PR
PR
PR
PR
PR
PR
"}
(14,1,1) = {"
PR
PR
PR
HV
HV
HV
HV
Xg
KX
bB
qe
Al
fy
sZ
PR
PR
PR
PR
PR
PR
PR
PR
"}
(15,1,1) = {"
PR
PR
PR
PR
PR
PR
HV
HV
HV
HV
uK
Fm
qc
sZ
PR
PR
PR
PR
PR
PR
PR
PR
"}
(16,1,1) = {"
PR
PR
PR
PR
PR
PR
PR
PR
PR
sZ
sZ
sZ
sZ
sZ
PR
PR
PR
PR
PR
PR
PR
PR
"}
