//MAP CONVERTED BY dmm2tgm.py THIS HEADER COMMENT PREVENTS RECONVERSION, DO NOT REMOVE
"as" = (
/obj/effect/landmark/start/broadcast_team,
/turf/open/floor/iron,
/area/station/service/studio/stage)
"bK" = (
/obj/structure/curtain/cloth,
/obj/machinery/atmospherics/pipe/smart/manifold4w/supply/hidden/layer4,
/turf/open/floor/carpet/green,
/area/station/service/studio)
"df" = (
/obj/structure/dresser,
/turf/open/floor/wood,
/area/station/service/studio)
"eA" = (
/obj/structure/table,
/obj/machinery/computer/security/telescreen/broadcast_team{
	dir = 1;
	pixel_y = 3
	},
/turf/open/floor/iron/dark,
/area/station/service/studio)
"ga" = (
/obj/effect/turf_decal/siding/dark{
	dir = 4
	},
/obj/machinery/atmospherics/pipe/smart/manifold4w/supply/hidden/layer4,
/turf/open/floor/iron,
/area/station/service/studio)
"it" = (
/obj/structure/sign/map/right{
	desc = "A framed picture of the station. Clockwise from security at the top (red), you see engineering (yellow), science (purple), escape (red and white), medbay (green), arrivals (blue and white), and finally cargo (brown).";
	icon_state = "map-right-MS";
	pixel_y = -32
	},
/obj/machinery/atmospherics/pipe/smart/manifold4w/scrubbers/hidden/layer2,
/obj/structure/disposalpipe/segment{
	dir = 9
	},
/obj/effect/turf_decal/tile/neutral/opposingcorners{
	dir = 1
	},
/obj/machinery/firealarm/directional/east,
/turf/open/floor/iron,
/area/station/hallway/primary/port)
"kF" = (
/obj/machinery/door/airlock/silver{
	name = "Bathroom";
	id_tag = "broadcastbathroom"
	},
/obj/effect/turf_decal/siding/dark{
	dir = 8
	},
/obj/machinery/atmospherics/pipe/smart/manifold4w/supply/hidden/layer4,
/obj/machinery/atmospherics/pipe/smart/manifold4w/scrubbers/hidden/layer2,
/turf/open/floor/iron/freezer,
/area/station/service/studio)
"kL" = (
/obj/machinery/vending/clothing,
/turf/open/floor/iron,
/area/station/service/studio)
"ln" = (
/obj/effect/turf_decal/siding/dark{
	dir = 4
	},
/obj/machinery/atmospherics/pipe/smart/manifold4w/supply/hidden/layer4,
/turf/open/floor/iron/dark,
/area/station/service/studio)
"mo" = (
/obj/effect/turf_decal/siding/dark{
	dir = 4
	},
/obj/machinery/atmospherics/pipe/smart/manifold4w/supply/hidden/layer4,
/obj/machinery/atmospherics/pipe/smart/manifold4w/scrubbers/hidden/layer2,
/turf/open/floor/iron/dark,
/area/station/service/studio)
"mr" = (
/obj/item/radio/intercom/broadcast/directional/north,
/turf/open/floor/iron,
/area/station/service/studio/stage)
"mS" = (
/obj/machinery/door/firedoor,
/obj/machinery/atmospherics/pipe/smart/manifold4w/supply/hidden/layer4,
/obj/machinery/atmospherics/pipe/smart/manifold4w/scrubbers/hidden/layer2,
/turf/open/floor/iron/dark,
/area/station/service/studio)
"nr" = (
/obj/machinery/light/small/directional/north,
/turf/open/floor/iron/dark,
/area/station/service/studio)
"ns" = (
/obj/effect/landmark/atmospheric_sanity/ignore_area,
/turf/open/floor/iron,
/area/station/service/studio/stage)
"oe" = (
/obj/machinery/button/door/directional/south{
	normaldoorcontrol = 1;
	specialfunctions = 4;
	id = "broadcastbathroom";
	name = "Bolt Control"
	},
/obj/machinery/atmospherics/pipe/smart/manifold4w/supply/hidden/layer4,
/obj/machinery/atmospherics/pipe/smart/manifold4w/scrubbers/hidden/layer2,
/turf/open/floor/iron/freezer,
/area/station/service/studio)
"oF" = (
/obj/effect/turf_decal/siding/dark{
	dir = 1
	},
/obj/machinery/door/airlock/service/studio,
/obj/effect/mapping_helpers/airlock/access/all/service/studio,
/obj/effect/mapping_helpers/airlock/autoname,
/turf/open/floor/iron/dark/textured_large,
/area/station/service/studio)
"pB" = (
/obj/effect/turf_decal/siding/dark{
	dir = 1
	},
/obj/machinery/door/airlock/maintenance,
/obj/effect/mapping_helpers/airlock/access/all/service/studio,
/obj/effect/mapping_helpers/airlock/autoname,
/obj/machinery/atmospherics/pipe/smart/manifold4w/supply/hidden/layer4,
/turf/open/floor/plating,
/area/station/maintenance/port)
"rV" = (
/obj/effect/turf_decal/siding/wood{
	dir = 1
	},
/obj/effect/turf_decal/siding/wood,
/obj/machinery/door/airlock/silver{
	id_tag = "dressingroombolts";
	name = "Dressing Room"
	},
/obj/effect/mapping_helpers/airlock/access/all/service/studio,
/obj/effect/mapping_helpers/airlock/unres{
	dir = 1
	},
/obj/machinery/atmospherics/pipe/smart/manifold4w/supply/hidden/layer4,
/obj/machinery/atmospherics/pipe/smart/manifold4w/scrubbers/hidden/layer2,
/turf/open/floor/wood/large,
/area/station/service/studio)
"sp" = (
/obj/machinery/vending/autodrobe,
/obj/machinery/light/small/directional/south,
/turf/open/floor/iron,
/area/station/service/studio)
"sB" = (
/obj/structure/cable,
/obj/machinery/power/apc/auto_name/directional/north,
/turf/open/floor/iron/dark,
/area/station/service/studio)
"sP" = (
/obj/machinery/airalarm/directional/south,
/turf/open/floor/iron/dark,
/area/station/service/studio)
"tB" = (
/obj/machinery/button/door/directional/south{
	normaldoorcontrol = 1;
	specialfunctions = 4;
	id = "dressingroombolts";
	name = "Bolt Control"
	},
/obj/machinery/atmospherics/pipe/smart/manifold4w/supply/hidden/layer4,
/turf/open/floor/wood,
/area/station/service/studio)
"tM" = (
/obj/structure/window/spawner/directional/east,
/obj/structure/toilet{
	pixel_y = 12
	},
/obj/effect/landmark/start/broadcast_team,
/obj/machinery/atmospherics/components/unary/vent_scrubber/on/layer2,
/turf/open/floor/iron/freezer,
/area/station/service/studio)
"uT" = (
/obj/machinery/autolathe,
/obj/effect/turf_decal/siding/dark{
	dir = 1
	},
/turf/open/floor/iron,
/area/station/service/studio)
"vZ" = (
/obj/machinery/atmospherics/components/unary/vent_scrubber/on/layer2{
	dir = 4
	},
/turf/open/floor/iron/dark,
/area/station/service/studio)
"wf" = (
/obj/structure/chair/stool/bar/directional/east,
/obj/structure/mirror/directional/east,
/obj/structure/window/spawner/directional/south,
/obj/machinery/atmospherics/components/unary/vent_pump/on/layer4,
/turf/open/floor/wood,
/area/station/service/studio)
"wu" = (
/obj/structure/rack,
/obj/machinery/atmospherics/components/unary/vent_scrubber/on/layer2,
/obj/machinery/light/small/directional/west,
/turf/open/floor/wood,
/area/station/service/studio)
"wP" = (
/turf/closed/wall,
/area/station/maintenance/port)
"xl" = (
/obj/structure/chair/plastic{
	dir = 4
	},
/obj/effect/landmark/start/broadcast_team,
/turf/open/floor/iron/dark,
/area/station/service/studio)
"yn" = (
/turf/open/floor/iron/dark,
/area/station/service/studio)
"yI" = (
/obj/machinery/light_switch/directional/east,
/obj/machinery/atmospherics/pipe/smart/manifold4w/scrubbers/hidden/layer2,
/obj/structure/cable,
/turf/open/floor/iron/dark,
/area/station/service/studio)
"An" = (
/obj/effect/turf_decal/siding/dark{
	dir = 4
	},
/obj/machinery/atmospherics/components/unary/vent_pump/on/layer4{
	dir = 1
	},
/turf/open/floor/iron/dark,
/area/station/service/studio)
"Ao" = (
/obj/machinery/power/floodlight,
/obj/structure/cable,
/turf/open/floor/catwalk_floor/iron_dark,
/area/station/service/studio)
"Aw" = (
/turf/template_noop,
/area/template_noop)
"Bg" = (
/obj/structure/table,
/obj/machinery/cell_charger,
/obj/item/stack/cable_coil,
/turf/open/floor/iron,
/area/station/service/studio)
"CZ" = (
/turf/open/floor/iron,
/area/station/service/studio/stage)
"Di" = (
/obj/machinery/rnd/production/circuit_imprinter,
/obj/effect/turf_decal/siding/dark{
	dir = 5
	},
/obj/machinery/atmospherics/pipe/smart/manifold4w/supply/hidden/layer4,
/turf/open/floor/iron,
/area/station/service/studio)
"DD" = (
/obj/machinery/atmospherics/pipe/smart/manifold4w/supply/hidden/layer4,
/obj/machinery/atmospherics/pipe/smart/manifold4w/scrubbers/hidden/layer2,
/turf/open/floor/iron/dark,
/area/station/service/studio)
"Fj" = (
/obj/structure/table,
/obj/machinery/button/showtime/broadcast_team,
/obj/item/reagent_containers/cup/glass/waterbottle{
	pixel_y = 12;
	pixel_x = 8
	},
/turf/open/floor/iron/dark,
/area/station/service/studio)
"FI" = (
/obj/machinery/atmospherics/pipe/smart/manifold4w/supply/hidden/layer4,
/obj/machinery/atmospherics/pipe/smart/manifold4w/scrubbers/hidden/layer2,
/turf/open/floor/wood,
/area/station/service/studio)
"FM" = (
/obj/structure/cable,
/obj/machinery/atmospherics/pipe/smart/manifold4w/supply/hidden/layer4,
/obj/machinery/atmospherics/pipe/smart/manifold4w/scrubbers/hidden/layer2,
/turf/open/floor/iron/dark,
/area/station/service/studio)
"Gx" = (
/obj/effect/turf_decal/siding/dark{
	dir = 1
	},
/obj/machinery/door/airlock/service/studio,
/obj/effect/mapping_helpers/airlock/access/all/service/studio,
/obj/effect/mapping_helpers/airlock/autoname,
/obj/machinery/atmospherics/pipe/smart/manifold4w/scrubbers/hidden/layer2,
/obj/structure/cable,
/obj/effect/landmark/navigate_destination,
/turf/open/floor/iron/dark/textured_large,
/area/station/service/studio)
"HJ" = (
/obj/structure/cable,
/obj/machinery/atmospherics/pipe/smart/manifold4w/scrubbers/hidden/layer2,
/obj/structure/disposalpipe/segment,
/obj/effect/turf_decal/tile/neutral{
	dir = 4
	},
/obj/structure/sign/poster/official/random/directional/east,
/turf/open/floor/iron,
/area/station/hallway/primary/port)
"HK" = (
/obj/structure/sink/directional/west,
/obj/structure/mirror/directional/east,
/obj/machinery/light/small/directional/south,
/obj/machinery/atmospherics/components/unary/vent_pump/on/layer4{
	dir = 8
	},
/turf/open/floor/iron/freezer,
/area/station/service/studio)
"Iq" = (
/obj/structure/table,
/obj/effect/spawner/random/engineering/material,
/obj/effect/spawner/random/engineering/material_cheap,
/obj/effect/spawner/random/decoration/generic,
/turf/open/floor/iron,
/area/station/service/studio)
"Lv" = (
/obj/structure/cable,
/obj/machinery/atmospherics/pipe/smart/manifold4w/scrubbers/hidden/layer2,
/turf/open/floor/iron/dark,
/area/station/service/studio)
"Mh" = (
/obj/effect/turf_decal/tile/neutral{
	dir = 8
	},
/turf/open/floor/iron,
/area/station/hallway/primary/port)
"Ms" = (
/obj/machinery/airalarm/directional/north,
/turf/open/floor/wood,
/area/station/service/studio)
"MI" = (
/turf/closed/wall,
/area/station/service/studio)
"Og" = (
/obj/machinery/camera/broadcast/directional/east{
	view_range = 4
	},
/turf/open/floor/iron,
/area/station/service/studio/stage)
"OW" = (
/obj/effect/turf_decal/siding/dark{
	dir = 1
	},
/turf/open/floor/iron,
/area/station/service/studio)
"PV" = (
/obj/machinery/shower/directional/south,
/obj/structure/curtain,
/obj/structure/drain,
/obj/machinery/airalarm/directional/east,
/turf/open/floor/iron/freezer,
/area/station/service/studio)
"Qk" = (
/obj/machinery/light/small/directional/west,
/obj/structure/chair/plastic{
	dir = 4
	},
/obj/effect/landmark/start/broadcast_team,
/turf/open/floor/iron/dark,
/area/station/service/studio)
"QN" = (
/obj/structure/safe/floor,
/obj/item/vending_refill/lustwish,
/obj/item/stack/cable_coil/five,
/turf/open/floor/wood,
/area/station/service/studio)
"Ru" = (
/obj/structure/bed/double,
/obj/item/bedsheet/green/double,
/turf/open/floor/carpet/green,
/area/station/service/studio)
"SM" = (
/obj/machinery/computer/camera_advanced/base_construction/broadcast{
	dir = 8
	},
/turf/open/floor/iron/dark,
/area/station/service/studio)
"Ts" = (
/obj/effect/turf_decal/siding/dark{
	dir = 4
	},
/turf/open/floor/iron/dark,
/area/station/service/studio)
"TK" = (
/obj/effect/turf_decal/siding/dark/corner,
/obj/machinery/atmospherics/pipe/smart/manifold4w/supply/hidden/layer4,
/obj/machinery/atmospherics/pipe/smart/manifold4w/scrubbers/hidden/layer2,
/turf/open/floor/iron/dark,
/area/station/service/studio)
"TR" = (
/obj/effect/landmark/start/broadcast_team,
/obj/structure/chair/office{
	dir = 4
	},
/turf/open/floor/iron/dark,
/area/station/service/studio)
"Uf" = (
/obj/structure/table,
/obj/item/storage/toolbox/mechanical{
	pixel_y = 10;
	pixel_x = 3
	},
/obj/item/storage/toolbox/mechanical{
	pixel_y = 5;
	pixel_x = 2
	},
/obj/item/multitool{
	pixel_x = -4
	},
/obj/item/multitool{
	pixel_x = 2
	},
/obj/effect/turf_decal/siding/dark{
	dir = 1
	},
/turf/open/floor/iron,
/area/station/service/studio)
"Wf" = (
/obj/machinery/firealarm/directional/north,
/turf/open/floor/iron/dark,
/area/station/service/studio)
"Yl" = (
/obj/machinery/airalarm/directional/west,
/obj/machinery/atmospherics/pipe/smart/manifold4w/supply/hidden/layer4,
/obj/machinery/atmospherics/pipe/smart/manifold4w/scrubbers/hidden/layer2,
/obj/machinery/light/small/directional/east,
/turf/open/floor/iron/dark,
/area/station/service/studio)
"YM" = (
/turf/open/floor/iron,
/area/station/service/studio)
"YS" = (
/obj/structure/chair/stool/bar/directional/east,
/obj/structure/mirror/directional/east,
/turf/open/floor/wood,
/area/station/service/studio)
"Zg" = (
/obj/item/radio/intercom/broadcast/directional/south,
/turf/open/floor/iron,
/area/station/service/studio/stage)
"Zo" = (
/turf/open/floor/catwalk_floor/iron_dark,
/area/station/service/studio)

(1,1,1) = {"
Aw
Aw
Aw
Aw
Aw
wP
wP
wP
wP
wP
wP
wP
wP
Aw
"}
(2,1,1) = {"
Aw
Aw
Aw
Aw
Mh
oF
yn
Qk
xl
Uf
Iq
Bg
wP
Aw
"}
(3,1,1) = {"
Aw
Aw
Aw
Aw
Mh
MI
yn
vZ
yn
OW
YM
kL
wP
Aw
"}
(4,1,1) = {"
Aw
Aw
Aw
Aw
Aw
Gx
yI
Lv
Lv
uT
YM
sp
wP
Aw
"}
(5,1,1) = {"
Aw
Aw
Aw
Aw
Aw
MI
MI
yn
FM
Di
ga
ga
pB
Aw
"}
(6,1,1) = {"
Aw
Aw
Aw
Aw
Aw
Aw
MI
nr
FM
yn
yn
sP
wP
Aw
"}
(7,1,1) = {"
Aw
Aw
Aw
Aw
Aw
Aw
MI
sB
FM
Zo
TR
eA
wP
Aw
"}
(8,1,1) = {"
Aw
Aw
Aw
Aw
Aw
MI
MI
Wf
FM
Ao
SM
Fj
wP
wP
"}
(9,1,1) = {"
Aw
Aw
Aw
HJ
it
MI
DD
TK
mo
ln
An
Ts
Ts
wP
"}
(10,1,1) = {"
MI
MI
MI
MI
MI
MI
mS
MI
ns
CZ
CZ
CZ
CZ
wP
"}
(11,1,1) = {"
MI
df
wu
FI
rV
Yl
DD
MI
CZ
CZ
as
CZ
CZ
wP
"}
(12,1,1) = {"
MI
Ms
QN
tB
MI
MI
kF
MI
mr
CZ
CZ
CZ
Zg
wP
"}
(13,1,1) = {"
MI
YS
wf
bK
MI
tM
oe
MI
CZ
as
CZ
as
CZ
wP
"}
(14,1,1) = {"
wP
wP
wP
Ru
MI
PV
HK
MI
CZ
CZ
Og
CZ
CZ
wP
"}
(15,1,1) = {"
Aw
Aw
wP
wP
wP
wP
wP
wP
wP
wP
wP
wP
wP
wP
"}
