//MAP CONVERTED BY dmm2tgm.py THIS HEADER COMMENT PREVENTS RECONVERSION, DO NOT REMOVE
"a" = (
/turf/closed/wall,
/area/station/service/broadcast_centre)
"d" = (
/obj/machinery/camera/broadcast/directional/east{
	view_range = 4
	},
/turf/open/floor/iron,
/area/station/service/broadcast_centre/stage)
"e" = (
/obj/structure/table,
/obj/machinery/cell_charger,
/obj/item/stack/cable_coil,
/turf/open/floor/iron,
/area/station/service/broadcast_centre)
"g" = (
/turf/template_noop,
/area/template_noop)
"h" = (
/obj/effect/turf_decal/siding/dark{
	dir = 1
	},
/turf/open/floor/iron,
/area/station/service/broadcast_centre)
"i" = (
/obj/machinery/autolathe,
/obj/effect/turf_decal/siding/dark{
	dir = 1
	},
/turf/open/floor/iron,
/area/station/service/broadcast_centre)
"j" = (
/obj/machinery/rnd/production/circuit_imprinter,
/obj/effect/turf_decal/siding/dark{
	dir = 5
	},
/turf/open/floor/iron,
/area/station/service/broadcast_centre)
"l" = (
/obj/machinery/vending/clothing,
/turf/open/floor/iron,
/area/station/service/broadcast_centre)
"o" = (
/obj/effect/landmark/start/broadcast_team,
/obj/structure/chair/office{
	dir = 4
	},
/turf/open/floor/iron/dark,
/area/station/service/broadcast_centre)
"p" = (
/obj/effect/turf_decal/siding/dark{
	dir = 1
	},
/obj/machinery/door/airlock/maintenance,
/obj/effect/mapping_helpers/airlock/access/all/service/broadcast_centre,
/obj/effect/mapping_helpers/airlock/autoname,
/obj/machinery/atmospherics/pipe/smart/manifold4w/supply/hidden/layer4,
/turf/open/floor/plating,
/area/station/maintenance/port)
"q" = (
/obj/effect/turf_decal/siding/dark{
	dir = 4
	},
/turf/open/floor/iron,
/area/station/service/broadcast_centre)
"r" = (
/turf/open/floor/iron/dark,
/area/station/service/broadcast_centre)
"s" = (
/obj/item/radio/intercom/broadcast/directional/south,
/turf/open/floor/iron,
/area/station/service/broadcast_centre/stage)
"u" = (
/obj/item/radio/intercom/broadcast/directional/north,
/turf/open/floor/iron,
/area/station/service/broadcast_centre/stage)
"v" = (
/obj/machinery/computer/camera_advanced/base_construction/broadcast{
	dir = 8
	},
/turf/open/floor/iron/dark,
/area/station/service/broadcast_centre)
"w" = (
/obj/effect/turf_decal/siding/dark{
	dir = 1
	},
/obj/machinery/door/airlock,
/obj/effect/mapping_helpers/airlock/access/all/service/broadcast_centre,
/obj/effect/mapping_helpers/airlock/autoname,
/obj/machinery/atmospherics/pipe/smart/manifold4w/scrubbers/hidden/layer2,
/obj/structure/cable,
/turf/open/floor/iron/dark/textured_large,
/area/station/service/broadcast_centre)
"x" = (
/obj/machinery/light_switch/directional/east,
/obj/machinery/atmospherics/pipe/smart/manifold4w/scrubbers/hidden/layer2,
/obj/structure/cable,
/turf/open/floor/iron/dark,
/area/station/service/broadcast_centre)
"y" = (
/obj/structure/table,
/obj/item/storage/toolbox/mechanical{
	pixel_y = 10;
	pixel_x = 3
	},
/obj/item/storage/toolbox/mechanical{
	pixel_y = 5;
	pixel_x = 2
	},
/obj/item/multitool{
	pixel_x = -4
	},
/obj/item/multitool{
	pixel_x = 2
	},
/obj/effect/turf_decal/siding/dark{
	dir = 1
	},
/turf/open/floor/iron,
/area/station/service/broadcast_centre)
"A" = (
/obj/structure/table,
/obj/machinery/button/showtime/broadcast_team,
/obj/item/reagent_containers/cup/glass/waterbottle{
	pixel_y = 12;
	pixel_x = 8
	},
/turf/open/floor/iron/dark,
/area/station/service/broadcast_centre)
"B" = (
/turf/open/floor/iron,
/area/station/service/broadcast_centre/stage)
"C" = (
/obj/effect/turf_decal/siding/dark/corner,
/turf/open/floor/iron/dark,
/area/station/service/broadcast_centre)
"F" = (
/obj/effect/turf_decal/siding/dark{
	dir = 1
	},
/obj/machinery/door/airlock,
/obj/effect/mapping_helpers/airlock/access/all/service/broadcast_centre,
/obj/effect/mapping_helpers/airlock/autoname,
/turf/open/floor/iron/dark/textured_large,
/area/station/service/broadcast_centre)
"H" = (
/obj/effect/turf_decal/siding/dark{
	dir = 4
	},
/turf/open/floor/iron/dark,
/area/station/service/broadcast_centre)
"J" = (
/obj/effect/turf_decal/siding/dark{
	dir = 4
	},
/obj/machinery/atmospherics/pipe/smart/manifold4w/supply/hidden/layer4,
/turf/open/floor/iron,
/area/station/service/broadcast_centre)
"K" = (
/turf/closed/wall,
/area/station/maintenance/port)
"L" = (
/obj/machinery/power/floodlight,
/turf/open/floor/catwalk_floor/iron_dark,
/area/station/service/broadcast_centre)
"M" = (
/obj/structure/cable,
/obj/machinery/atmospherics/pipe/smart/manifold4w/scrubbers/hidden/layer2,
/obj/structure/disposalpipe/segment,
/obj/effect/turf_decal/tile/neutral{
	dir = 4
	},
/obj/structure/sign/poster/official/random/directional/east,
/turf/open/floor/iron,
/area/station/hallway/primary/port)
"O" = (
/turf/open/floor/catwalk_floor/iron_dark,
/area/station/service/broadcast_centre)
"P" = (
/obj/effect/landmark/start/broadcast_team,
/turf/open/floor/iron,
/area/station/service/broadcast_centre/stage)
"S" = (
/obj/structure/table,
/obj/machinery/computer/security/telescreen/broadcast_team{
	dir = 1;
	pixel_y = 3
	},
/turf/open/floor/iron/dark,
/area/station/service/broadcast_centre)
"T" = (
/turf/open/floor/iron,
/area/station/service/broadcast_centre)
"U" = (
/obj/effect/turf_decal/tile/neutral{
	dir = 8
	},
/turf/open/floor/iron,
/area/station/hallway/primary/port)
"V" = (
/obj/structure/table,
/obj/effect/spawner/random/engineering/material,
/obj/effect/spawner/random/engineering/material_cheap,
/obj/effect/spawner/random/decoration/generic,
/turf/open/floor/iron,
/area/station/service/broadcast_centre)
"W" = (
/obj/machinery/vending/autodrobe,
/turf/open/floor/iron,
/area/station/service/broadcast_centre)
"X" = (
/obj/effect/decal/cleanable/dirt,
/turf/closed/wall,
/area/station/service/broadcast_centre)
"Z" = (
/obj/structure/sign/map/right{
	desc = "A framed picture of the station. Clockwise from security at the top (red), you see engineering (yellow), science (purple), escape (red and white), medbay (green), arrivals (blue and white), and finally cargo (brown).";
	icon_state = "map-right-MS";
	pixel_y = -32
	},
/obj/machinery/atmospherics/pipe/smart/manifold4w/scrubbers/hidden/layer2,
/obj/structure/disposalpipe/segment{
	dir = 9
	},
/obj/effect/turf_decal/tile/neutral/opposingcorners{
	dir = 1
	},
/obj/machinery/firealarm/directional/east,
/turf/open/floor/iron,
/area/station/hallway/primary/port)

(1,1,1) = {"
g
g
g
g
g
K
K
K
K
K
K
K
K
g
"}
(2,1,1) = {"
g
g
g
g
U
F
r
r
r
y
V
e
K
g
"}
(3,1,1) = {"
g
g
g
g
U
a
r
r
r
h
T
l
K
g
"}
(4,1,1) = {"
g
g
g
g
g
w
x
r
r
i
T
W
K
g
"}
(5,1,1) = {"
g
g
g
g
g
a
a
r
r
j
q
J
p
g
"}
(6,1,1) = {"
g
g
g
g
g
g
a
r
r
r
r
r
K
g
"}
(7,1,1) = {"
g
g
g
g
g
g
a
r
r
O
o
S
K
g
"}
(8,1,1) = {"
g
g
g
g
g
a
a
r
r
L
v
A
K
K
"}
(9,1,1) = {"
g
g
g
M
Z
a
r
C
H
H
H
H
H
K
"}
(10,1,1) = {"
a
a
a
a
X
X
r
a
B
B
B
B
B
K
"}
(11,1,1) = {"
a
r
r
r
r
r
r
a
B
B
P
B
B
K
"}
(12,1,1) = {"
a
r
r
r
r
r
r
a
u
B
B
B
s
K
"}
(13,1,1) = {"
a
r
r
r
r
r
r
a
B
P
B
P
B
K
"}
(14,1,1) = {"
K
K
K
r
r
r
r
a
B
B
d
B
B
K
"}
(15,1,1) = {"
g
g
K
K
K
K
K
K
K
K
K
K
K
K
"}
