//MAP CONVERTED BY dmm2tgm.py THIS HEADER COMMENT PREVENTS RECONVERSION, DO NOT REMOVE
"co" = (
/obj/machinery/firealarm/directional/north,
/turf/open/floor/iron/dark,
/area/station/service/broadcast_centre)
"dz" = (
/obj/machinery/atmospherics/pipe/smart/manifold4w/supply/hidden/layer4,
/obj/machinery/atmospherics/pipe/smart/manifold4w/scrubbers/hidden/layer2,
/turf/open/floor/iron/dark,
/area/station/service/broadcast_centre)
"dE" = (
/obj/structure/chair/plastic{
	dir = 4
	},
/obj/effect/landmark/start/broadcast_team,
/turf/open/floor/iron/dark,
/area/station/service/broadcast_centre)
"dF" = (
/obj/structure/cable,
/obj/machinery/atmospherics/pipe/smart/manifold4w/supply/hidden/layer4,
/obj/machinery/atmospherics/pipe/smart/manifold4w/scrubbers/hidden/layer2,
/turf/open/floor/iron/dark,
/area/station/service/broadcast_centre)
"dJ" = (
/obj/effect/turf_decal/siding/dark{
	dir = 4
	},
/obj/machinery/atmospherics/pipe/smart/manifold4w/supply/hidden/layer4,
/obj/machinery/atmospherics/pipe/smart/manifold4w/scrubbers/hidden/layer2,
/turf/open/floor/iron/dark,
/area/station/service/broadcast_centre)
"hd" = (
/obj/structure/table,
/obj/machinery/cell_charger,
/obj/item/stack/cable_coil,
/turf/open/floor/iron,
/area/station/service/broadcast_centre)
"hO" = (
/obj/structure/table,
/obj/machinery/button/showtime/broadcast_team,
/obj/item/reagent_containers/cup/glass/waterbottle{
	pixel_y = 12;
	pixel_x = 8
	},
/turf/open/floor/iron/dark,
/area/station/service/broadcast_centre)
"hR" = (
/obj/machinery/atmospherics/components/unary/vent_scrubber/on/layer2{
	dir = 4
	},
/turf/open/floor/iron/dark,
/area/station/service/broadcast_centre)
"ii" = (
/obj/machinery/vending/autodrobe,
/obj/machinery/light/small/directional/south,
/turf/open/floor/iron,
/area/station/service/broadcast_centre)
"jn" = (
/obj/effect/turf_decal/siding/dark{
	dir = 1
	},
/obj/machinery/door/airlock,
/obj/effect/mapping_helpers/airlock/access/all/service/broadcast_centre,
/obj/effect/mapping_helpers/airlock/autoname,
/turf/open/floor/iron/dark/textured_large,
/area/station/service/broadcast_centre)
"ka" = (
/obj/machinery/camera/broadcast/directional/east{
	view_range = 4
	},
/turf/open/floor/iron,
/area/station/service/broadcast_centre/stage)
"kf" = (
/obj/structure/window/spawner/directional/east,
/obj/structure/toilet{
	pixel_y = 12
	},
/obj/effect/landmark/start/broadcast_team,
/obj/machinery/atmospherics/components/unary/vent_scrubber/on/layer2,
/turf/open/floor/iron/freezer,
/area/station/service/broadcast_centre)
"kq" = (
/obj/item/radio/intercom/broadcast/directional/north,
/turf/open/floor/iron,
/area/station/service/broadcast_centre/stage)
"mn" = (
/obj/structure/table,
/obj/machinery/computer/security/telescreen/broadcast_team{
	dir = 1;
	pixel_y = 3
	},
/turf/open/floor/iron/dark,
/area/station/service/broadcast_centre)
"nb" = (
/obj/machinery/shower/directional/south,
/obj/structure/curtain,
/obj/structure/drain,
/obj/machinery/airalarm/directional/east,
/turf/open/floor/iron/freezer,
/area/station/service/broadcast_centre)
"oO" = (
/obj/effect/turf_decal/siding/dark{
	dir = 1
	},
/obj/machinery/door/airlock,
/obj/effect/mapping_helpers/airlock/access/all/service/broadcast_centre,
/obj/effect/mapping_helpers/airlock/autoname,
/obj/machinery/atmospherics/pipe/smart/manifold4w/scrubbers/hidden/layer2,
/obj/structure/cable,
/turf/open/floor/iron/dark/textured_large,
/area/station/service/broadcast_centre)
"pI" = (
/obj/structure/sink/directional/west,
/obj/structure/mirror/directional/east,
/obj/machinery/light/small/directional/south,
/obj/machinery/atmospherics/components/unary/vent_pump/on/layer4{
	dir = 8
	},
/turf/open/floor/iron/freezer,
/area/station/service/broadcast_centre)
"qI" = (
/obj/item/radio/intercom/broadcast/directional/south,
/turf/open/floor/iron,
/area/station/service/broadcast_centre/stage)
"qM" = (
/obj/machinery/computer/camera_advanced/base_construction/broadcast{
	dir = 8
	},
/turf/open/floor/iron/dark,
/area/station/service/broadcast_centre)
"qV" = (
/obj/machinery/airalarm/directional/south,
/turf/open/floor/iron/dark,
/area/station/service/broadcast_centre)
"rc" = (
/obj/effect/turf_decal/siding/wood{
	dir = 1
	},
/obj/effect/turf_decal/siding/wood,
/obj/machinery/door/airlock{
	id_tag = "dressingroombolts";
	name = "Dressing Room"
	},
/obj/effect/mapping_helpers/airlock/access/all/service/broadcast_centre,
/obj/effect/mapping_helpers/airlock/unres{
	dir = 1
	},
/obj/machinery/atmospherics/pipe/smart/manifold4w/supply/hidden/layer4,
/obj/machinery/atmospherics/pipe/smart/manifold4w/scrubbers/hidden/layer2,
/turf/open/floor/wood/large,
/area/station/service/broadcast_centre)
"ru" = (
/obj/effect/turf_decal/siding/dark/corner,
/obj/machinery/atmospherics/pipe/smart/manifold4w/supply/hidden/layer4,
/obj/machinery/atmospherics/pipe/smart/manifold4w/scrubbers/hidden/layer2,
/turf/open/floor/iron/dark,
/area/station/service/broadcast_centre)
"rV" = (
/obj/effect/landmark/start/broadcast_team,
/obj/structure/chair/office{
	dir = 4
	},
/turf/open/floor/iron/dark,
/area/station/service/broadcast_centre)
"ud" = (
/turf/closed/wall,
/area/station/service/broadcast_centre)
"vN" = (
/obj/structure/curtain/cloth,
/obj/machinery/atmospherics/pipe/smart/manifold4w/supply/hidden/layer4,
/turf/open/floor/carpet/green,
/area/station/service/broadcast_centre)
"vR" = (
/obj/machinery/power/floodlight,
/obj/structure/cable,
/turf/open/floor/catwalk_floor/iron_dark,
/area/station/service/broadcast_centre)
"vW" = (
/turf/closed/wall,
/area/station/maintenance/port)
"wl" = (
/turf/open/floor/iron,
/area/station/service/broadcast_centre/stage)
"wI" = (
/obj/structure/table,
/obj/effect/spawner/random/engineering/material,
/obj/effect/spawner/random/engineering/material_cheap,
/obj/effect/spawner/random/decoration/generic,
/turf/open/floor/iron,
/area/station/service/broadcast_centre)
"xr" = (
/obj/machinery/autolathe,
/obj/effect/turf_decal/siding/dark{
	dir = 1
	},
/turf/open/floor/iron,
/area/station/service/broadcast_centre)
"zj" = (
/obj/structure/chair/stool/bar/directional/east,
/obj/structure/mirror/directional/east,
/turf/open/floor/wood,
/area/station/service/broadcast_centre)
"zz" = (
/obj/structure/rack,
/obj/machinery/atmospherics/components/unary/vent_scrubber/on/layer2,
/obj/machinery/light/small/directional/west,
/turf/open/floor/wood,
/area/station/service/broadcast_centre)
"Aw" = (
/obj/machinery/light_switch/directional/east,
/obj/machinery/atmospherics/pipe/smart/manifold4w/scrubbers/hidden/layer2,
/obj/structure/cable,
/turf/open/floor/iron/dark,
/area/station/service/broadcast_centre)
"AN" = (
/turf/open/floor/catwalk_floor/iron_dark,
/area/station/service/broadcast_centre)
"Bh" = (
/obj/effect/turf_decal/siding/dark{
	dir = 4
	},
/obj/machinery/atmospherics/pipe/smart/manifold4w/supply/hidden/layer4,
/turf/open/floor/iron/dark,
/area/station/service/broadcast_centre)
"Bu" = (
/obj/structure/bed/double,
/obj/item/bedsheet/green/double,
/turf/open/floor/carpet/green,
/area/station/service/broadcast_centre)
"Dr" = (
/obj/machinery/button/door/directional/south{
	normaldoorcontrol = 1;
	specialfunctions = 4;
	id = "dressingroombolts";
	name = "Bolt Control"
	},
/obj/machinery/atmospherics/pipe/smart/manifold4w/supply/hidden/layer4,
/turf/open/floor/wood,
/area/station/service/broadcast_centre)
"EO" = (
/obj/structure/cable,
/obj/machinery/atmospherics/pipe/smart/manifold4w/scrubbers/hidden/layer2,
/turf/open/floor/iron/dark,
/area/station/service/broadcast_centre)
"FB" = (
/obj/effect/turf_decal/siding/dark{
	dir = 1
	},
/obj/machinery/door/airlock/maintenance,
/obj/effect/mapping_helpers/airlock/access/all/service/broadcast_centre,
/obj/effect/mapping_helpers/airlock/autoname,
/obj/machinery/atmospherics/pipe/smart/manifold4w/supply/hidden/layer4,
/turf/open/floor/plating,
/area/station/maintenance/port)
"FR" = (
/obj/structure/dresser,
/turf/open/floor/wood,
/area/station/service/broadcast_centre)
"Gy" = (
/obj/machinery/airalarm/directional/west,
/obj/machinery/atmospherics/pipe/smart/manifold4w/supply/hidden/layer4,
/obj/machinery/atmospherics/pipe/smart/manifold4w/scrubbers/hidden/layer2,
/turf/open/floor/iron/dark,
/area/station/service/broadcast_centre)
"Hw" = (
/obj/machinery/rnd/production/circuit_imprinter,
/obj/effect/turf_decal/siding/dark{
	dir = 5
	},
/obj/machinery/atmospherics/pipe/smart/manifold4w/supply/hidden/layer4,
/turf/open/floor/iron,
/area/station/service/broadcast_centre)
"HC" = (
/obj/machinery/door/firedoor,
/obj/machinery/atmospherics/pipe/smart/manifold4w/supply/hidden/layer4,
/obj/machinery/atmospherics/pipe/smart/manifold4w/scrubbers/hidden/layer2,
/turf/open/floor/iron/dark,
/area/station/service/broadcast_centre)
"In" = (
/obj/effect/turf_decal/siding/dark{
	dir = 4
	},
/obj/machinery/atmospherics/components/unary/vent_pump/on/layer4{
	dir = 1
	},
/turf/open/floor/iron/dark,
/area/station/service/broadcast_centre)
"Ju" = (
/obj/machinery/door/airlock/silver{
	name = "Bathroom";
	id_tag = "broadcastbathroom"
	},
/obj/effect/turf_decal/siding/dark{
	dir = 8
	},
/obj/machinery/atmospherics/pipe/smart/manifold4w/supply/hidden/layer4,
/obj/machinery/atmospherics/pipe/smart/manifold4w/scrubbers/hidden/layer2,
/turf/open/floor/iron/freezer,
/area/station/service/broadcast_centre)
"JN" = (
/obj/effect/turf_decal/siding/dark{
	dir = 1
	},
/turf/open/floor/iron,
/area/station/service/broadcast_centre)
"Ka" = (
/turf/open/floor/iron/dark,
/area/station/service/broadcast_centre)
"Kf" = (
/turf/open/floor/iron,
/area/station/service/broadcast_centre)
"KR" = (
/obj/structure/cable,
/obj/machinery/power/apc/auto_name/directional/north,
/turf/open/floor/iron/dark,
/area/station/service/broadcast_centre)
"LA" = (
/obj/machinery/button/door/directional/south{
	normaldoorcontrol = 1;
	specialfunctions = 4;
	id = "broadcastbathroom";
	name = "Bolt Control"
	},
/obj/machinery/atmospherics/pipe/smart/manifold4w/supply/hidden/layer4,
/obj/machinery/atmospherics/pipe/smart/manifold4w/scrubbers/hidden/layer2,
/turf/open/floor/iron/freezer,
/area/station/service/broadcast_centre)
"NL" = (
/obj/effect/turf_decal/siding/dark{
	dir = 4
	},
/obj/machinery/atmospherics/pipe/smart/manifold4w/supply/hidden/layer4,
/turf/open/floor/iron,
/area/station/service/broadcast_centre)
"NN" = (
/obj/effect/turf_decal/tile/neutral{
	dir = 8
	},
/turf/open/floor/iron,
/area/station/hallway/primary/port)
"Pe" = (
/obj/effect/landmark/start/broadcast_team,
/turf/open/floor/iron,
/area/station/service/broadcast_centre/stage)
"Qh" = (
/obj/machinery/vending/clothing,
/turf/open/floor/iron,
/area/station/service/broadcast_centre)
"Qn" = (
/turf/template_noop,
/area/template_noop)
"Qv" = (
/obj/machinery/light/small/directional/north,
/turf/open/floor/iron/dark,
/area/station/service/broadcast_centre)
"Tf" = (
/obj/machinery/atmospherics/pipe/smart/manifold4w/supply/hidden/layer4,
/obj/machinery/atmospherics/pipe/smart/manifold4w/scrubbers/hidden/layer2,
/turf/open/floor/wood,
/area/station/service/broadcast_centre)
"Tt" = (
/obj/structure/cable,
/obj/machinery/atmospherics/pipe/smart/manifold4w/scrubbers/hidden/layer2,
/obj/structure/disposalpipe/segment,
/obj/effect/turf_decal/tile/neutral{
	dir = 4
	},
/obj/structure/sign/poster/official/random/directional/east,
/turf/open/floor/iron,
/area/station/hallway/primary/port)
"TS" = (
/obj/structure/safe/floor,
/obj/item/vending_refill/lustwish,
/obj/item/stack/cable_coil/five,
/turf/open/floor/wood,
/area/station/service/broadcast_centre)
"VH" = (
/obj/structure/table,
/obj/item/storage/toolbox/mechanical{
	pixel_y = 10;
	pixel_x = 3
	},
/obj/item/storage/toolbox/mechanical{
	pixel_y = 5;
	pixel_x = 2
	},
/obj/item/multitool{
	pixel_x = -4
	},
/obj/item/multitool{
	pixel_x = 2
	},
/obj/effect/turf_decal/siding/dark{
	dir = 1
	},
/turf/open/floor/iron,
/area/station/service/broadcast_centre)
"VK" = (
/obj/machinery/light/small/directional/west,
/obj/structure/chair/plastic{
	dir = 4
	},
/obj/effect/landmark/start/broadcast_team,
/turf/open/floor/iron/dark,
/area/station/service/broadcast_centre)
"VX" = (
/obj/effect/decal/cleanable/dirt,
/turf/closed/wall,
/area/station/service/broadcast_centre)
"We" = (
/obj/structure/chair/stool/bar/directional/east,
/obj/structure/mirror/directional/east,
/obj/structure/window/spawner/directional/south,
/obj/machinery/atmospherics/components/unary/vent_pump/on/layer4,
/turf/open/floor/wood,
/area/station/service/broadcast_centre)
"WQ" = (
/obj/effect/turf_decal/siding/dark{
	dir = 4
	},
/turf/open/floor/iron/dark,
/area/station/service/broadcast_centre)
"YS" = (
/obj/structure/sign/map/right{
	desc = "A framed picture of the station. Clockwise from security at the top (red), you see engineering (yellow), science (purple), escape (red and white), medbay (green), arrivals (blue and white), and finally cargo (brown).";
	icon_state = "map-right-MS";
	pixel_y = -32
	},
/obj/machinery/atmospherics/pipe/smart/manifold4w/scrubbers/hidden/layer2,
/obj/structure/disposalpipe/segment{
	dir = 9
	},
/obj/effect/turf_decal/tile/neutral/opposingcorners{
	dir = 1
	},
/obj/machinery/firealarm/directional/east,
/turf/open/floor/iron,
/area/station/hallway/primary/port)
"Zs" = (
/obj/machinery/airalarm/directional/north,
/turf/open/floor/wood,
/area/station/service/broadcast_centre)

(1,1,1) = {"
Qn
Qn
Qn
Qn
Qn
vW
vW
vW
vW
vW
vW
vW
vW
Qn
"}
(2,1,1) = {"
Qn
Qn
Qn
Qn
NN
jn
Ka
VK
dE
VH
wI
hd
vW
Qn
"}
(3,1,1) = {"
Qn
Qn
Qn
Qn
NN
ud
Ka
hR
Ka
JN
Kf
Qh
vW
Qn
"}
(4,1,1) = {"
Qn
Qn
Qn
Qn
Qn
oO
Aw
EO
EO
xr
Kf
ii
vW
Qn
"}
(5,1,1) = {"
Qn
Qn
Qn
Qn
Qn
ud
ud
Ka
dF
Hw
NL
NL
FB
Qn
"}
(6,1,1) = {"
Qn
Qn
Qn
Qn
Qn
Qn
ud
Qv
dF
Ka
Ka
qV
vW
Qn
"}
(7,1,1) = {"
Qn
Qn
Qn
Qn
Qn
Qn
ud
KR
dF
AN
rV
mn
vW
Qn
"}
(8,1,1) = {"
Qn
Qn
Qn
Qn
Qn
ud
ud
co
dF
vR
qM
hO
vW
vW
"}
(9,1,1) = {"
Qn
Qn
Qn
Tt
YS
ud
dz
ru
dJ
Bh
In
WQ
WQ
vW
"}
(10,1,1) = {"
ud
ud
ud
ud
VX
VX
HC
ud
wl
wl
wl
wl
wl
vW
"}
(11,1,1) = {"
ud
FR
zz
Tf
rc
Gy
dz
ud
wl
wl
Pe
wl
wl
vW
"}
(12,1,1) = {"
ud
Zs
TS
Dr
ud
ud
Ju
ud
kq
wl
wl
wl
qI
vW
"}
(13,1,1) = {"
ud
zj
We
vN
ud
kf
LA
ud
wl
Pe
wl
Pe
wl
vW
"}
(14,1,1) = {"
vW
vW
vW
Bu
ud
nb
pI
ud
wl
wl
ka
wl
wl
vW
"}
(15,1,1) = {"
Qn
Qn
vW
vW
vW
vW
vW
vW
vW
vW
vW
vW
vW
vW
"}
