//MAP CONVERTED BY dmm2tgm.py THIS HEADER COMMENT PREVENTS RECONVERSION, DO NOT REMOVE
"a" = (
/obj/machinery/computer/shuttle/interlink{
	dir = 4
	},
/turf/open/floor/iron,
/area/station/hallway/secondary/entry)

(1,1,1) = {"
a
"}
