//MAP CONVERTED BY dmm2tgm.py THIS HEADER COMMENT PREVENTS RECONVERSION, DO NOT REMOVE
"a" = (
/turf/template_noop,
/area/template_noop)
"b" = (
/obj/machinery/cryopod{
	dir = 8
	},
/obj/effect/turf_decal/siding/white{
	dir = 8
	},
/turf/open/floor/iron/dark,
/area/station/commons/cryo)
"g" = (
/obj/structure/cable,
/obj/machinery/atmospherics/pipe/smart/manifold4w/supply/hidden/layer4,
/obj/machinery/atmospherics/pipe/smart/manifold4w/scrubbers/hidden/layer2,
/obj/machinery/door/airlock/public/glass{
	name = "Cryopods"
	},
/turf/open/floor/iron,
/area/station/commons/cryo)
"i" = (
/obj/structure/chair/stool/directional/east,
/obj/machinery/atmospherics/pipe/smart/manifold4w/scrubbers/hidden/layer2,
/obj/machinery/atmospherics/pipe/smart/manifold4w/supply/hidden/layer4,
/turf/open/floor/iron,
/area/station/commons/fitness/recreation)
"j" = (
/obj/structure/lattice,
/obj/structure/chair/sofa/corp/right{
	dir = 1
	},
/turf/open/space/basic,
/area/space)
"l" = (
/obj/structure/lattice,
/turf/open/space/basic,
/area/space)
"m" = (
/turf/open/space/basic,
/area/space)
"u" = (
/obj/structure/cable,
/obj/machinery/atmospherics/pipe/smart/manifold4w/supply/hidden/layer4,
/obj/machinery/atmospherics/pipe/smart/manifold4w/scrubbers/hidden/layer2,
/obj/effect/turf_decal/tile/neutral{
	dir = 8
	},
/turf/open/floor/iron,
/area/station/commons/fitness/recreation)
"v" = (
/obj/machinery/atmospherics/pipe/smart/manifold4w/scrubbers/hidden/layer2,
/obj/machinery/atmospherics/pipe/smart/manifold4w/supply/hidden/layer4,
/turf/open/floor/iron,
/area/station/commons/fitness/recreation)
"w" = (
/obj/effect/turf_decal/tile/neutral{
	dir = 4
	},
/obj/machinery/atmospherics/components/unary/vent_scrubber/on/layer2{
	dir = 8
	},
/turf/open/floor/iron,
/area/station/commons/fitness/recreation)
"x" = (
/obj/structure/cable,
/obj/machinery/atmospherics/pipe/smart/manifold4w/supply/hidden/layer4,
/turf/open/floor/iron,
/area/station/commons/cryo)
"y" = (
/obj/machinery/power/apc/auto_name/directional/north,
/obj/structure/cable,
/obj/machinery/cryopod{
	dir = 8
	},
/obj/effect/turf_decal/siding/white{
	dir = 8
	},
/turf/open/floor/iron/dark,
/area/station/commons/cryo)
"z" = (
/obj/structure/cable,
/obj/effect/turf_decal/tile/neutral{
	dir = 1
	},
/obj/machinery/atmospherics/pipe/smart/manifold4w/scrubbers/hidden/layer2,
/obj/machinery/atmospherics/pipe/smart/manifold4w/supply/hidden/layer4,
/turf/open/floor/iron,
/area/station/commons/fitness/recreation)
"C" = (
/obj/structure/cable,
/obj/machinery/atmospherics/pipe/smart/manifold4w/supply/hidden/layer4,
/obj/machinery/atmospherics/pipe/smart/manifold4w/scrubbers/hidden/layer2,
/turf/open/floor/iron,
/area/station/commons/cryo)
"D" = (
/obj/effect/spawner/structure/window/reinforced,
/turf/open/floor/plating,
/area/station/commons/cryo)
"F" = (
/obj/machinery/cryopod{
	dir = 8
	},
/obj/effect/turf_decal/siding/white{
	dir = 8
	},
/obj/machinery/atmospherics/components/unary/vent_scrubber/on/layer2{
	dir = 8
	},
/turf/open/floor/iron/dark,
/area/station/commons/cryo)
"G" = (
/obj/machinery/cryopod{
	dir = 4
	},
/obj/effect/turf_decal/siding/white{
	dir = 4
	},
/turf/open/floor/iron/dark,
/area/station/commons/cryo)
"H" = (
/turf/closed/wall,
/area/station/commons/cryo)
"I" = (
/obj/effect/landmark/navigate_destination,
/obj/machinery/atmospherics/pipe/smart/manifold4w/scrubbers/hidden/layer2,
/obj/machinery/atmospherics/pipe/smart/manifold4w/supply/hidden/layer4,
/turf/open/floor/iron,
/area/station/commons/fitness/recreation)
"J" = (
/obj/structure/lattice,
/obj/structure/chair/sofa/corp/left{
	dir = 1
	},
/turf/open/space/basic,
/area/space)
"K" = (
/obj/machinery/airalarm/directional/north,
/obj/machinery/cryopod{
	dir = 4
	},
/obj/effect/turf_decal/siding/white{
	dir = 4
	},
/obj/machinery/camera/directional/north,
/obj/machinery/atmospherics/components/unary/vent_pump/on/layer4{
	dir = 4
	},
/turf/open/floor/iron/dark,
/area/station/commons/cryo)
"L" = (
/obj/effect/turf_decal/tile/neutral/fourcorners,
/obj/structure/cable,
/obj/machinery/atmospherics/pipe/smart/manifold4w/supply/hidden/layer4,
/obj/machinery/atmospherics/pipe/smart/manifold4w/scrubbers/hidden/layer2,
/turf/open/floor/iron/dark,
/area/station/commons/fitness/recreation)
"N" = (
/obj/effect/turf_decal/siding/white{
	dir = 4
	},
/obj/machinery/computer/cryopod/directional/west,
/turf/open/floor/iron/dark,
/area/station/commons/cryo)
"O" = (
/obj/effect/spawner/structure/window/reinforced,
/turf/open/floor/plating,
/area/station/commons/fitness/recreation)
"P" = (
/obj/structure/cable,
/obj/machinery/light/directional/north,
/obj/machinery/atmospherics/pipe/smart/manifold4w/supply/hidden/layer4,
/turf/open/floor/iron,
/area/station/commons/cryo)
"U" = (
/obj/structure/grille,
/obj/structure/lattice,
/turf/open/space/basic,
/area/space)
"W" = (
/obj/structure/grille/broken,
/turf/open/floor/plating/airless,
/area/space)

(1,1,1) = {"
H
D
D
D
H
a
a
a
a
a
a
a
a
a
a
"}
(2,1,1) = {"
H
K
G
N
H
a
a
a
a
a
a
a
a
a
a
"}
(3,1,1) = {"
H
P
x
C
g
L
z
v
v
v
i
v
v
I
u
"}
(4,1,1) = {"
H
y
b
F
D
a
a
a
a
a
a
a
a
w
a
"}
(5,1,1) = {"
H
D
D
D
H
a
a
a
a
a
a
a
a
a
a
"}
(6,1,1) = {"
U
m
l
m
O
a
a
a
a
a
a
a
a
a
a
"}
(7,1,1) = {"
W
m
J
m
O
a
a
a
a
a
a
a
a
a
a
"}
(8,1,1) = {"
W
m
j
m
O
a
a
a
a
a
a
a
a
a
a
"}
