//MAP CONVERTED BY dmm2tgm.py THIS HEADER COMMENT PREVENTS RECONVERSION, DO NOT REMOVE
"a" = (
/obj/machinery/atmospherics/pipe/smart/manifold4w/supply/hidden/layer4,
/turf/open/floor/iron,
/area/station/commons/cryo)
"b" = (
/obj/machinery/cryopod{
	dir = 4
	},
/obj/effect/turf_decal/siding/white{
	dir = 4
	},
/turf/open/floor/iron/dark,
/area/station/commons/cryo)
"f" = (
/obj/structure/cable,
/obj/machinery/atmospherics/pipe/smart/manifold4w/supply/hidden/layer4,
/obj/machinery/atmospherics/pipe/smart/manifold4w/scrubbers/hidden/layer2,
/obj/machinery/door/airlock/public/glass{
	name = "Cryopods"
	},
/obj/effect/landmark/navigate_destination,
/turf/open/floor/iron,
/area/station/commons/cryo)
"j" = (
/obj/effect/turf_decal/siding/white{
	dir = 9
	},
/obj/machinery/light/directional/east,
/obj/machinery/computer/cryopod/directional/east,
/turf/open/floor/iron/dark,
/area/station/commons/cryo)
"k" = (
/obj/structure/cable,
/obj/machinery/atmospherics/pipe/smart/manifold4w/supply/hidden/layer4,
/obj/machinery/atmospherics/pipe/smart/manifold4w/scrubbers/hidden/layer2,
/turf/open/floor/iron,
/area/station/commons/cryo)
"v" = (
/obj/effect/spawner/structure/window,
/turf/open/floor/plating,
/area/station/commons/cryo)
"y" = (
/turf/template_noop,
/area/template_noop)
"z" = (
/obj/machinery/cryopod{
	dir = 8
	},
/obj/effect/turf_decal/siding/white{
	dir = 8
	},
/obj/machinery/atmospherics/components/unary/vent_pump/on/layer4{
	dir = 8
	},
/turf/open/floor/iron/dark,
/area/station/commons/cryo)
"C" = (
/turf/closed/wall,
/area/station/commons/cryo)
"E" = (
/obj/machinery/cryopod{
	dir = 4
	},
/obj/effect/turf_decal/siding/white{
	dir = 4
	},
/obj/machinery/power/apc/auto_name/directional/north,
/obj/structure/cable,
/obj/machinery/atmospherics/components/unary/vent_scrubber/on/layer2{
	dir = 4
	},
/obj/machinery/camera/directional/west,
/turf/open/floor/iron/dark,
/area/station/commons/cryo)
"K" = (
/obj/structure/cable,
/obj/machinery/atmospherics/pipe/smart/manifold4w/supply/hidden/layer4,
/obj/machinery/atmospherics/pipe/smart/manifold4w/scrubbers/hidden/layer2,
/obj/machinery/light/directional/north,
/turf/open/floor/iron,
/area/station/commons/cryo)
"M" = (
/obj/effect/turf_decal/tile/neutral{
	dir = 1
	},
/obj/effect/turf_decal/tile/neutral{
	dir = 8
	},
/obj/structure/cable,
/obj/machinery/atmospherics/pipe/smart/manifold4w/supply/hidden/layer4,
/obj/machinery/atmospherics/pipe/smart/manifold4w/scrubbers/hidden/layer2,
/turf/open/floor/iron,
/area/station/commons/dorms)
"T" = (
/turf/open/floor/iron,
/area/station/hallway/primary/central)
"Y" = (
/obj/machinery/atmospherics/pipe/smart/manifold4w/supply/hidden/layer4,
/obj/machinery/airalarm/directional/south,
/turf/open/floor/iron,
/area/station/commons/cryo)

(1,1,1) = {"
C
C
C
v
v
y
"}
(2,1,1) = {"
C
E
b
b
v
y
"}
(3,1,1) = {"
C
k
a
Y
C
y
"}
(4,1,1) = {"
C
K
j
z
v
T
"}
(5,1,1) = {"
C
f
C
v
v
y
"}
(6,1,1) = {"
y
M
y
y
y
y
"}
