//MAP CONVERTED BY dmm2tgm.py THIS HEADER COMMENT PREVENTS RECONVERSION, DO NOT REMOVE
"a" = (
/turf/open/openspace,
/area/station/commons/fitness)
"c" = (
/obj/structure/cable,
/obj/machinery/atmospherics/pipe/multiz/supply/hidden/layer4{
	dir = 4
	},
/obj/machinery/atmospherics/pipe/multiz/scrubbers/hidden/layer2{
	dir = 4
	},
/turf/open/floor/plating,
/area/station/maintenance/starboard/fore)
"d" = (
/obj/structure/cable/multilayer/multiz,
/turf/open/floor/plating,
/area/station/maintenance/starboard/fore)
"e" = (
/obj/effect/turf_decal/siding/white{
	dir = 1
	},
/obj/structure/railing{
	dir = 1
	},
/obj/machinery/door/firedoor/border_only{
	dir = 1
	},
/obj/structure/disposalpipe/segment{
	dir = 4
	},
/obj/structure/cable,
/turf/open/floor/iron,
/area/station/commons/fitness)
"g" = (
/obj/structure/disposalpipe/segment{
	dir = 6
	},
/obj/effect/decal/cleanable/cobweb,
/obj/machinery/atmospherics/pipe/smart/manifold4w/supply/hidden/layer4,
/obj/machinery/atmospherics/pipe/smart/manifold4w/scrubbers/hidden/layer2,
/obj/structure/cable,
/obj/structure/railing{
	dir = 8
	},
/turf/open/floor/plating,
/area/station/maintenance/starboard/fore)
"h" = (
/obj/effect/turf_decal/siding/white/corner{
	dir = 8
	},
/obj/structure/railing/corner{
	dir = 8
	},
/turf/open/floor/iron,
/area/station/commons/fitness)
"i" = (
/obj/machinery/atmospherics/components/unary/vent_scrubber/on/layer2{
	dir = 8
	},
/obj/effect/turf_decal/siding/white/corner,
/obj/structure/railing/corner,
/turf/open/floor/iron,
/area/station/commons/fitness)
"j" = (
/obj/effect/turf_decal/siding/white{
	dir = 4
	},
/obj/machinery/door/firedoor/border_only{
	dir = 4
	},
/turf/open/floor/iron,
/area/station/commons/fitness)
"k" = (
/obj/machinery/holopad,
/obj/machinery/atmospherics/pipe/smart/manifold4w/scrubbers/hidden/layer2,
/obj/machinery/atmospherics/pipe/smart/manifold4w/supply/hidden/layer4,
/obj/effect/turf_decal/siding/white{
	dir = 4
	},
/obj/structure/railing{
	dir = 4
	},
/obj/machinery/door/firedoor/border_only{
	dir = 4
	},
/turf/open/floor/iron,
/area/station/commons/fitness)
"m" = (
/obj/structure/disposalpipe/segment{
	dir = 4
	},
/obj/effect/turf_decal/siding/white{
	dir = 1
	},
/obj/structure/railing{
	dir = 1
	},
/obj/machinery/door/firedoor/border_only{
	dir = 1
	},
/obj/structure/cable,
/turf/open/floor/iron,
/area/station/commons/fitness)
"n" = (
/obj/effect/turf_decal/weather/snow/corner{
	dir = 6
	},
/turf/open/floor/glass/reinforced/icemoon,
/area/icemoon/surface/outdoors/nospawn)
"o" = (
/obj/structure/disposalpipe/sorting/mail,
/obj/effect/mapping_helpers/mail_sorting/service/bar,
/obj/machinery/atmospherics/pipe/smart/manifold4w/supply/hidden/layer4,
/obj/machinery/atmospherics/pipe/smart/manifold4w/scrubbers/hidden/layer2,
/obj/effect/decal/cleanable/dirt,
/obj/structure/cable,
/turf/open/floor/plating,
/area/station/maintenance/starboard/fore)
"p" = (
/obj/structure/disposalpipe/segment{
	dir = 4
	},
/obj/machinery/atmospherics/pipe/smart/manifold4w/scrubbers/hidden/layer2,
/obj/machinery/atmospherics/pipe/smart/manifold4w/supply/hidden/layer4,
/obj/effect/turf_decal/tile/neutral{
	dir = 8
	},
/obj/effect/turf_decal/siding/white/corner{
	dir = 4
	},
/obj/structure/railing/corner{
	dir = 4
	},
/obj/structure/cable,
/turf/open/floor/iron,
/area/station/commons/fitness)
"t" = (
/obj/machinery/atmospherics/pipe/smart/manifold4w/scrubbers/hidden/layer2,
/obj/machinery/atmospherics/pipe/smart/manifold4w/supply/hidden/layer4,
/obj/effect/turf_decal/siding/white{
	dir = 4
	},
/obj/structure/railing{
	dir = 4
	},
/obj/machinery/door/firedoor/border_only{
	dir = 4
	},
/obj/structure/cable,
/turf/open/floor/iron,
/area/station/commons/fitness)
"u" = (
/obj/structure/disposalpipe/segment,
/obj/machinery/door/airlock/maintenance{
	name = "Fitness Maintenance"
	},
/obj/effect/mapping_helpers/airlock/access/any/service/maintenance,
/obj/effect/mapping_helpers/airlock/unres,
/obj/machinery/atmospherics/pipe/smart/manifold4w/supply/hidden/layer4,
/obj/machinery/atmospherics/pipe/smart/manifold4w/scrubbers/hidden/layer2,
/obj/structure/cable,
/turf/open/floor/plating,
/area/station/maintenance/starboard/fore)
"v" = (
/obj/effect/turf_decal/siding/white/corner{
	dir = 1
	},
/obj/structure/railing/corner{
	dir = 1
	},
/obj/structure/disposalpipe/segment{
	dir = 10
	},
/obj/structure/cable,
/turf/open/floor/iron,
/area/station/commons/fitness)
"y" = (
/turf/template_noop,
/area/template_noop)
"z" = (
/obj/effect/turf_decal/tile/neutral/anticorner/contrasted,
/obj/structure/disposalpipe/segment,
/obj/machinery/atmospherics/pipe/smart/manifold4w/scrubbers/hidden/layer2,
/obj/machinery/atmospherics/pipe/smart/manifold4w/supply/hidden/layer4,
/obj/structure/cable,
/turf/open/floor/iron,
/area/station/commons/fitness)
"A" = (
/obj/effect/turf_decal/siding/white{
	dir = 8
	},
/obj/machinery/door/firedoor/border_only{
	dir = 8
	},
/turf/open/floor/iron,
/area/station/commons/fitness)
"B" = (
/obj/effect/turf_decal/weather/snow/corner{
	dir = 10
	},
/turf/open/floor/glass/reinforced/icemoon,
/area/icemoon/surface/outdoors/nospawn)
"D" = (
/obj/effect/landmark/start/hangover,
/obj/effect/turf_decal/siding/white{
	dir = 8
	},
/obj/structure/railing{
	dir = 8
	},
/obj/machinery/door/firedoor/border_only{
	dir = 8
	},
/turf/open/floor/iron,
/area/station/commons/fitness)
"E" = (
/turf/open/misc/asteroid/snow/icemoon,
/area/icemoon/surface/outdoors/nospawn)
"H" = (
/obj/effect/turf_decal/siding/white{
	dir = 8
	},
/obj/structure/railing{
	dir = 8
	},
/obj/machinery/door/firedoor/border_only{
	dir = 8
	},
/turf/open/floor/iron,
/area/station/commons/fitness)
"K" = (
/obj/structure/disposalpipe/segment{
	dir = 4
	},
/obj/machinery/atmospherics/pipe/smart/manifold4w/supply/hidden/layer4,
/obj/machinery/atmospherics/pipe/smart/manifold4w/scrubbers/hidden/layer2,
/obj/structure/cable,
/turf/open/floor/plating,
/area/station/maintenance/starboard/fore)
"M" = (
/obj/effect/turf_decal/weather/snow/corner{
	dir = 1
	},
/turf/open/floor/glass/reinforced/icemoon,
/area/icemoon/surface/outdoors/nospawn)
"P" = (
/turf/open/floor/plating/snowed/smoothed/icemoon,
/area/icemoon/surface/outdoors/nospawn)
"T" = (
/obj/effect/turf_decal/weather/snow/corner{
	dir = 9
	},
/turf/open/floor/glass/reinforced/icemoon,
/area/icemoon/surface/outdoors/nospawn)
"U" = (
/obj/effect/landmark/start/hangover,
/obj/effect/turf_decal/siding/white,
/obj/structure/railing,
/obj/machinery/door/firedoor/border_only,
/turf/open/floor/iron,
/area/station/commons/fitness)
"V" = (
/obj/effect/turf_decal/weather/snow/corner,
/turf/open/floor/glass/reinforced/icemoon,
/area/icemoon/surface/outdoors/nospawn)
"X" = (
/obj/effect/turf_decal/siding/white,
/obj/structure/railing,
/obj/machinery/door/firedoor/border_only,
/turf/open/floor/iron,
/area/station/commons/fitness)
"Y" = (
/obj/structure/disposalpipe/segment{
	dir = 4
	},
/obj/machinery/light/small/dim/directional/north,
/obj/effect/decal/cleanable/vomit/old,
/obj/machinery/atmospherics/pipe/smart/manifold4w/supply/hidden/layer4,
/obj/machinery/atmospherics/pipe/smart/manifold4w/scrubbers/hidden/layer2,
/obj/structure/cable,
/turf/open/floor/plating,
/area/station/maintenance/starboard/fore)
"Z" = (
/obj/effect/turf_decal/weather/snow/corner{
	dir = 5
	},
/turf/open/floor/glass/reinforced/icemoon,
/area/icemoon/surface/outdoors/nospawn)

(1,1,1) = {"
y
y
y
y
y
y
y
y
y
y
y
y
i
j
j
k
t
p
y
y
d
"}
(2,1,1) = {"
y
y
y
y
y
y
y
y
y
y
y
y
U
a
a
a
a
m
y
y
c
"}
(3,1,1) = {"
y
y
y
y
y
y
y
y
y
y
y
y
X
a
a
a
a
e
y
y
g
"}
(4,1,1) = {"
y
y
y
y
y
y
y
y
y
y
y
y
X
a
a
a
a
e
y
y
K
"}
(5,1,1) = {"
y
y
y
y
y
y
y
y
y
y
y
y
X
a
a
a
a
e
y
y
Y
"}
(6,1,1) = {"
y
y
y
y
y
y
y
y
y
y
y
y
h
D
H
A
A
v
z
u
o
"}
(7,1,1) = {"
y
y
y
y
y
y
y
y
y
y
y
y
y
y
y
y
y
y
y
y
y
"}
(8,1,1) = {"
y
y
y
y
y
y
y
y
y
y
y
y
y
y
y
y
y
y
y
y
y
"}
(9,1,1) = {"
y
y
y
y
y
y
y
T
B
y
y
y
y
y
y
y
y
y
y
y
y
"}
(10,1,1) = {"
y
y
y
y
y
y
y
M
V
y
y
y
y
y
y
y
y
y
y
y
y
"}
(11,1,1) = {"
y
y
y
y
y
y
y
M
V
y
y
y
y
y
y
y
y
y
y
y
y
"}
(12,1,1) = {"
y
E
E
y
y
y
y
Z
n
y
y
y
y
y
y
y
y
y
y
y
y
"}
(13,1,1) = {"
E
E
E
y
y
y
y
P
P
y
y
y
y
y
y
y
y
y
y
y
y
"}
(14,1,1) = {"
E
E
E
y
y
y
y
y
y
y
y
y
y
y
y
y
y
y
y
y
y
"}
(15,1,1) = {"
y
E
y
y
y
y
y
y
y
y
y
y
y
y
y
y
y
y
y
y
y
"}
