//MAP CONVERTED BY dmm2tgm.py THIS HEADER COMMENT PREVENTS RECONVERSION, DO NOT REMOVE
"ad" = (
/obj/machinery/atmospherics/pipe/smart/manifold4w/supply/hidden/layer4,
/obj/machinery/atmospherics/pipe/smart/manifold4w/scrubbers/hidden/layer2,
/obj/structure/cable,
/turf/open/floor/catwalk_floor/iron,
/area/station/service/studio)
"az" = (
/obj/machinery/atmospherics/pipe/smart/manifold4w/supply/hidden/layer4,
/obj/machinery/atmospherics/pipe/smart/manifold4w/scrubbers/hidden/layer2,
/obj/machinery/light/small/directional/north,
/turf/open/floor/iron/freezer,
/area/station/service/studio)
"by" = (
/turf/closed/wall,
/area/station/service/studio)
"bR" = (
/obj/machinery/vending/clothing,
/obj/effect/turf_decal/siding/wideplating_new/dark{
	dir = 9
	},
/obj/effect/turf_decal/trimline/dark_green/corner,
/obj/machinery/firealarm/directional/north,
/turf/open/floor/iron,
/area/station/service/studio)
"ea" = (
/obj/effect/turf_decal/siding/dark,
/obj/effect/turf_decal/trimline/dark_green/warning,
/obj/machinery/atmospherics/components/unary/vent_scrubber/on/layer2{
	dir = 1
	},
/turf/open/floor/iron/dark,
/area/station/service/studio)
"ej" = (
/obj/effect/spawner/structure/window/hollow/reinforced/middle{
	dir = 4
	},
/turf/open/floor/plating,
/area/station/service/studio)
"eF" = (
/obj/machinery/door/airlock/silver{
	name = "Bathroom";
	id_tag = "broadcastbathroom"
	},
/obj/machinery/atmospherics/pipe/smart/manifold4w/supply/hidden/layer4,
/obj/machinery/atmospherics/pipe/smart/manifold4w/scrubbers/hidden/layer2,
/turf/open/floor/iron/freezer,
/area/station/service/studio)
"gw" = (
/obj/effect/turf_decal/siding/wideplating_new/dark{
	dir = 8
	},
/obj/effect/turf_decal/trimline/dark_green/warning{
	dir = 4
	},
/obj/structure/cable,
/obj/machinery/power/apc/auto_name/directional/west,
/turf/open/floor/iron,
/area/station/service/studio)
"gA" = (
/turf/template_noop,
/area/template_noop)
"gG" = (
/obj/structure/table,
/obj/item/storage/toolbox/mechanical{
	pixel_y = 10;
	pixel_x = 3
	},
/obj/item/storage/toolbox/mechanical{
	pixel_y = 5;
	pixel_x = 2
	},
/obj/item/multitool{
	pixel_x = -4
	},
/obj/item/multitool{
	pixel_x = 2
	},
/obj/effect/turf_decal/siding/wideplating_new/dark,
/obj/effect/turf_decal/trimline/dark_green/warning{
	dir = 1
	},
/turf/open/floor/iron,
/area/station/service/studio)
"gZ" = (
/obj/item/radio/intercom/broadcast/directional/west,
/turf/open/floor/iron,
/area/station/service/studio/stage)
"ha" = (
/obj/structure/table,
/obj/item/storage/toolbox/emergency,
/turf/open/floor/plastic,
/area/station/commons/dorms/laundry)
"hc" = (
/obj/effect/turf_decal/trimline/dark_green/corner,
/obj/effect/turf_decal/siding/dark/corner,
/obj/machinery/light/directional/south,
/turf/open/floor/iron/dark,
/area/station/service/studio)
"hx" = (
/obj/structure/table,
/obj/item/storage/backpack{
	pixel_x = 4;
	pixel_y = 4
	},
/obj/item/storage/backpack,
/turf/open/floor/plastic,
/area/station/commons/dorms/laundry)
"iR" = (
/obj/machinery/atmospherics/components/unary/vent_pump/on/layer4{
	dir = 8
	},
/turf/open/floor/iron/dark,
/area/station/service/studio)
"jg" = (
/obj/structure/table,
/obj/effect/spawner/random/entertainment/wallet_storage,
/obj/effect/spawner/random/clothing/kittyears_or_rabbitears,
/turf/open/floor/plastic,
/area/station/commons/dorms/laundry)
"kb" = (
/obj/effect/turf_decal/siding/dark,
/obj/effect/turf_decal/trimline/dark_green/warning,
/obj/machinery/airalarm/directional/east,
/turf/open/floor/iron/dark,
/area/station/service/studio)
"lq" = (
/obj/effect/turf_decal/siding/wideplating_new/dark{
	dir = 6
	},
/obj/effect/turf_decal/trimline/dark_green/corner{
	dir = 1
	},
/turf/open/floor/iron,
/area/station/service/studio)
"lQ" = (
/obj/effect/spawner/structure/window/reinforced/tinted,
/turf/open/floor/plating,
/area/station/service/studio)
"mo" = (
/obj/structure/mirror/directional/south,
/obj/structure/chair/stool/bar/directional/south,
/obj/machinery/atmospherics/components/unary/vent_pump/on/layer4{
	dir = 1
	},
/turf/open/floor/wood,
/area/station/service/studio)
"mX" = (
/obj/machinery/button/door/directional/north{
	id = "dressingroombolts";
	name = "Door Bolt Control";
	normaldoorcontrol = 1;
	specialfunctions = 4
	},
/obj/structure/rack,
/obj/machinery/atmospherics/components/unary/vent_scrubber/on/layer2{
	dir = 4
	},
/turf/open/floor/wood,
/area/station/service/studio)
"pg" = (
/obj/machinery/camera/broadcast/directional/south,
/turf/open/floor/iron,
/area/station/service/studio/stage)
"rp" = (
/obj/effect/landmark/atmospheric_sanity/ignore_area,
/turf/open/floor/iron,
/area/station/service/studio/stage)
"rZ" = (
/obj/effect/landmark/start/broadcast_team,
/turf/open/floor/iron,
/area/station/service/studio/stage)
"wH" = (
/obj/structure/dresser,
/obj/machinery/airalarm/directional/south,
/turf/open/floor/wood,
/area/station/service/studio)
"zn" = (
/obj/structure/table,
/obj/machinery/computer/security/telescreen/broadcast_team{
	dir = 1;
	pixel_y = 3
	},
/turf/open/floor/iron/dark,
/area/station/service/studio)
"zt" = (
/obj/effect/turf_decal/siding/wideplating_new/dark{
	dir = 10
	},
/obj/effect/turf_decal/trimline/dark_green/corner{
	dir = 4
	},
/obj/machinery/atmospherics/pipe/smart/manifold4w/supply/hidden/layer4,
/obj/machinery/atmospherics/pipe/smart/manifold4w/scrubbers/hidden/layer2,
/turf/open/floor/iron,
/area/station/service/studio)
"AJ" = (
/obj/machinery/computer/camera_advanced/base_construction/broadcast{
	dir = 1
	},
/turf/open/floor/iron/dark,
/area/station/service/studio)
"Bn" = (
/obj/machinery/power/floodlight,
/obj/structure/cable,
/obj/machinery/atmospherics/pipe/smart/manifold4w/scrubbers/hidden/layer2,
/turf/open/floor/catwalk_floor/iron_dark,
/area/station/service/studio)
"BL" = (
/obj/structure/table,
/obj/machinery/cell_charger,
/obj/item/stack/cable_coil,
/obj/effect/spawner/random/engineering/material,
/obj/effect/spawner/random/engineering/material_cheap,
/obj/effect/spawner/random/decoration/generic,
/obj/effect/turf_decal/siding/wideplating_new/dark,
/obj/effect/turf_decal/trimline/dark_green/warning{
	dir = 1
	},
/obj/machinery/atmospherics/pipe/smart/manifold4w/supply/hidden/layer4,
/obj/machinery/atmospherics/pipe/smart/manifold4w/scrubbers/hidden/layer2,
/turf/open/floor/iron,
/area/station/service/studio)
"BO" = (
/obj/structure/chair/office,
/obj/effect/landmark/start/broadcast_team,
/turf/open/floor/iron/dark,
/area/station/service/studio)
"Cg" = (
/obj/structure/table,
/obj/item/reagent_containers/cup/glass/waterbottle{
	pixel_y = 12;
	pixel_x = 8
	},
/obj/machinery/button/showtime/broadcast_team,
/obj/structure/extinguisher_cabinet/directional/east,
/turf/open/floor/iron/dark,
/area/station/service/studio)
"Cm" = (
/obj/structure/cable,
/obj/machinery/atmospherics/pipe/smart/manifold4w/supply/hidden/layer4,
/obj/machinery/atmospherics/pipe/smart/manifold4w/scrubbers/hidden/layer2,
/turf/open/floor/catwalk_floor/iron_dark,
/area/station/service/studio)
"Dh" = (
/obj/machinery/rnd/production/circuit_imprinter,
/obj/effect/turf_decal/siding/wideplating_new/dark{
	dir = 5
	},
/obj/effect/turf_decal/trimline/dark_green/corner{
	dir = 8
	},
/turf/open/floor/iron,
/area/station/service/studio)
"Fh" = (
/turf/open/floor/iron/dark,
/area/station/service/studio)
"Fm" = (
/obj/structure/table,
/obj/item/storage/wallet,
/obj/item/storage/wallet{
	pixel_y = 3;
	pixel_x = 4
	},
/turf/open/floor/plastic,
/area/station/commons/dorms/laundry)
"FR" = (
/obj/structure/chair/stool/directional/west,
/obj/machinery/light/small/directional/south,
/obj/effect/turf_decal/siding/blue{
	dir = 4
	},
/obj/effect/turf_decal/tile/neutral/opposingcorners{
	dir = 1
	},
/obj/machinery/status_display/evac/directional/south,
/obj/structure/cable,
/obj/machinery/atmospherics/pipe/smart/manifold4w/supply/hidden/layer4,
/obj/machinery/atmospherics/pipe/smart/manifold4w/scrubbers/hidden/layer2,
/turf/open/floor/iron,
/area/station/commons/dorms/laundry)
"GF" = (
/obj/machinery/autolathe,
/obj/effect/turf_decal/siding/wideplating_new/dark{
	dir = 1
	},
/obj/effect/turf_decal/trimline/dark_green/warning,
/turf/open/floor/iron,
/area/station/service/studio)
"HP" = (
/obj/effect/turf_decal/siding/wood,
/obj/effect/turf_decal/siding/wood{
	dir = 1
	},
/obj/machinery/door/airlock/silver{
	id_tag = "dressingroombolts";
	name = "Dressing Room"
	},
/obj/machinery/atmospherics/pipe/smart/manifold4w/supply/hidden/layer4,
/obj/machinery/atmospherics/pipe/smart/manifold4w/scrubbers/hidden/layer2,
/turf/open/floor/wood/large,
/area/station/service/studio)
"HR" = (
/obj/machinery/vending/autodrobe,
/obj/effect/turf_decal/siding/wideplating_new/dark{
	dir = 1
	},
/obj/effect/turf_decal/trimline/dark_green/warning,
/turf/open/floor/iron,
/area/station/service/studio)
"MU" = (
/obj/machinery/camera/directional/south{
	c_tag = "Broadcast Studio"
	},
/turf/open/floor/iron/dark,
/area/station/service/studio)
"Na" = (
/obj/structure/cable,
/obj/machinery/atmospherics/pipe/smart/manifold4w/supply/hidden/layer4,
/obj/machinery/atmospherics/pipe/smart/manifold4w/scrubbers/hidden/layer2,
/obj/machinery/door/airlock/service/studio,
/obj/effect/mapping_helpers/airlock/access/all/service/studio,
/obj/effect/mapping_helpers/airlock/autoname,
/obj/effect/landmark/navigate_destination,
/obj/effect/turf_decal/siding/blue{
	dir = 1
	},
/turf/open/floor/iron/dark/textured_large,
/area/station/service/studio)
"Nh" = (
/obj/effect/turf_decal/trimline/dark_green/warning,
/turf/open/floor/plastic,
/area/station/commons/dorms/laundry)
"NV" = (
/obj/item/radio/intercom/broadcast/directional/east,
/turf/open/floor/iron,
/area/station/service/studio/stage)
"Od" = (
/obj/machinery/atmospherics/pipe/smart/manifold4w/supply/hidden/layer4,
/obj/machinery/atmospherics/pipe/smart/manifold4w/scrubbers/hidden/layer2,
/turf/open/floor/iron/dark,
/area/station/service/studio)
"Pg" = (
/obj/machinery/shower/directional/north,
/obj/structure/curtain,
/obj/structure/drain,
/turf/open/floor/iron/freezer,
/area/station/service/studio)
"Pq" = (
/obj/effect/turf_decal/siding/blue{
	dir = 4
	},
/obj/effect/turf_decal/tile/neutral/opposingcorners{
	dir = 1
	},
/obj/structure/cable,
/obj/machinery/atmospherics/pipe/smart/manifold4w/supply/hidden/layer4,
/obj/machinery/atmospherics/pipe/smart/manifold4w/scrubbers/hidden/layer2,
/turf/open/floor/iron,
/area/station/commons/dorms/laundry)
"PG" = (
/obj/structure/cable,
/obj/machinery/atmospherics/pipe/smart/manifold4w/supply/hidden/layer4,
/obj/machinery/atmospherics/pipe/smart/manifold4w/scrubbers/hidden/layer2,
/obj/effect/turf_decal/trimline/dark_green/corner,
/turf/open/floor/plastic,
/area/station/commons/dorms/laundry)
"PS" = (
/obj/structure/cable,
/obj/machinery/atmospherics/pipe/smart/manifold4w/supply/hidden/layer4,
/obj/machinery/atmospherics/pipe/smart/manifold4w/scrubbers/hidden/layer2,
/obj/effect/turf_decal/trimline/dark_green/warning,
/turf/open/floor/plastic,
/area/station/commons/dorms/laundry)
"Rv" = (
/turf/open/floor/iron,
/area/station/service/studio/stage)
"RF" = (
/obj/machinery/door/airlock/service/studio,
/obj/effect/mapping_helpers/airlock/access/all/service/studio,
/obj/effect/mapping_helpers/airlock/autoname,
/obj/effect/turf_decal/siding/blue{
	dir = 1
	},
/turf/open/floor/iron/dark/textured_large,
/area/station/service/studio)
"Sm" = (
/obj/machinery/light/small/directional/east,
/obj/structure/safe/floor,
/obj/item/vending_refill/lustwish,
/obj/item/stack/cable_coil/five,
/obj/machinery/atmospherics/pipe/smart/manifold4w/supply/hidden/layer4,
/obj/machinery/atmospherics/pipe/smart/manifold4w/scrubbers/hidden/layer2,
/turf/open/floor/wood,
/area/station/service/studio)
"Vr" = (
/obj/machinery/button/door/directional/east{
	normaldoorcontrol = 1;
	specialfunctions = 4;
	id = "broadcastbathroom";
	name = "Bolt Control"
	},
/obj/structure/sink/directional/north,
/obj/structure/mirror/directional/south,
/obj/structure/window/spawner/directional/west,
/obj/machinery/atmospherics/components/unary/vent_scrubber/on/layer2{
	dir = 1
	},
/turf/open/floor/iron/freezer,
/area/station/service/studio)
"VD" = (
/obj/structure/cable,
/obj/machinery/atmospherics/pipe/smart/manifold4w/supply/hidden/layer4,
/obj/machinery/atmospherics/pipe/smart/manifold4w/scrubbers/hidden/layer2,
/turf/open/floor/iron/dark,
/area/station/service/studio)
"VY" = (
/obj/effect/landmark/start/hangover,
/obj/effect/turf_decal/siding/blue{
	dir = 4
	},
/obj/effect/turf_decal/tile/neutral/opposingcorners{
	dir = 1
	},
/obj/structure/cable,
/obj/machinery/atmospherics/pipe/smart/manifold4w/supply/hidden/layer4,
/obj/machinery/atmospherics/pipe/smart/manifold4w/scrubbers/hidden/layer2,
/turf/open/floor/iron,
/area/station/commons/dorms/laundry)
"Ws" = (
/obj/effect/turf_decal/siding/dark,
/obj/effect/turf_decal/trimline/dark_green/warning,
/turf/open/floor/iron/dark,
/area/station/service/studio)
"YG" = (
/obj/structure/toilet{
	pixel_y = 12
	},
/obj/machinery/airalarm/directional/west,
/obj/machinery/atmospherics/components/unary/vent_pump/on/layer4{
	dir = 4
	},
/turf/open/floor/iron/freezer,
/area/station/service/studio)
"Zt" = (
/obj/effect/turf_decal/siding/wideplating_new/dark{
	dir = 4
	},
/obj/effect/turf_decal/trimline/dark_green/warning{
	dir = 8
	},
/obj/machinery/atmospherics/pipe/smart/manifold4w/supply/hidden/layer4,
/obj/machinery/atmospherics/pipe/smart/manifold4w/scrubbers/hidden/layer2,
/obj/structure/cable,
/turf/open/floor/iron,
/area/station/service/studio)

(1,1,1) = {"
gA
gA
gA
gA
gA
by
by
by
by
gA
gA
gA
gA
gA
"}
(2,1,1) = {"
gA
gA
gA
gA
gA
by
YG
Pg
by
gA
gA
gA
gA
gA
"}
(3,1,1) = {"
gA
gA
gA
gA
gA
by
az
Vr
by
gA
gA
gA
gA
gA
"}
(4,1,1) = {"
gA
gA
gA
by
by
by
eF
by
by
ej
ej
by
gA
gA
"}
(5,1,1) = {"
gA
gA
gA
by
bR
gw
zt
MU
by
mX
wH
by
gA
gA
"}
(6,1,1) = {"
gA
gA
gA
by
HR
ad
BL
Od
HP
Sm
mo
by
gA
gA
"}
(7,1,1) = {"
VY
Pq
FR
by
GF
ad
gG
hc
by
by
by
by
by
by
"}
(8,1,1) = {"
gA
gA
PG
by
Dh
Zt
lq
Ws
rp
Rv
gZ
Rv
Rv
by
"}
(9,1,1) = {"
hx
ha
PS
Na
VD
Cm
Bn
ea
Rv
Rv
Rv
rZ
Rv
by
"}
(10,1,1) = {"
jg
Fm
Nh
lQ
iR
BO
AJ
Ws
Rv
rZ
Rv
Rv
pg
by
"}
(11,1,1) = {"
gA
gA
Nh
RF
Fh
Cg
zn
Ws
Rv
Rv
Rv
rZ
Rv
by
"}
(12,1,1) = {"
gA
gA
gA
by
by
by
by
kb
Rv
Rv
NV
Rv
Rv
by
"}
(13,1,1) = {"
gA
gA
gA
gA
gA
gA
by
by
by
by
by
by
by
by
"}
