//MAP CONVERTED BY dmm2tgm.py THIS HEADER COMMENT PREVENTS RECONVERSION, DO NOT REMOVE
"ao" = (
/obj/effect/turf_decal/trimline/purple/filled/line,
/turf/open/floor/iron,
/area/template_noop)
"aQ" = (
/obj/effect/turf_decal/stripes/line{
	dir = 1
	},
/obj/effect/turf_decal/stripes/line,
/turf/open/floor/plating,
/area/template_noop)
"aS" = (
/turf/open/floor/iron/large,
/area/template_noop)
"bO" = (
/obj/effect/turf_decal/tile/blue/half/contrasted{
	dir = 1
	},
/turf/open/floor/mineral/titanium/tiled,
/area/template_noop)
"bP" = (
/obj/effect/turf_decal/trimline/green/filled/line{
	dir = 1
	},
/turf/open/floor/iron,
/area/template_noop)
"cK" = (
/obj/machinery/door/firedoor,
/turf/open/floor/plating,
/area/template_noop)
"dl" = (
/obj/effect/turf_decal/tile/yellow{
	dir = 1
	},
/turf/open/floor/mineral/titanium/tiled,
/area/template_noop)
"dQ" = (
/turf/open/floor/mineral/titanium/yellow,
/area/template_noop)
"eh" = (
/turf/template_noop,
/area/template_noop)
"eo" = (
/obj/effect/turf_decal/trimline/yellow/filled/line{
	dir = 4
	},
/obj/effect/turf_decal/trimline/blue/filled/line{
	dir = 1
	},
/obj/effect/turf_decal/siding/thinplating_new{
	dir = 8
	},
/turf/open/floor/mineral/titanium/tiled,
/area/template_noop)
"eA" = (
/obj/effect/spawner/structure/window/reinforced,
/turf/open/floor/plating,
/area/template_noop)
"fB" = (
/obj/machinery/power/shuttle_engine/propulsion,
/turf/open/floor/plating/ocean_plating,
/area/template_noop)
"fR" = (
/obj/structure/window/reinforced/spawner/directional/south,
/obj/machinery/power/shuttle_engine/heater,
/turf/open/floor/plating,
/area/template_noop)
"hc" = (
/obj/effect/turf_decal/siding/wood,
/turf/open/floor/wood,
/area/template_noop)
"hG" = (
/turf/open/floor/plating,
/area/template_noop)
"kD" = (
/obj/effect/turf_decal/tile/green/full,
/turf/open/floor/iron/large,
/area/template_noop)
"kS" = (
/turf/open/floor/mineral/titanium/tiled,
/area/template_noop)
"ld" = (
/obj/structure/window/reinforced/spawner/directional/north,
/turf/open/floor/mineral/titanium/tiled,
/area/template_noop)
"lt" = (
/obj/effect/turf_decal/tile/purple/half/contrasted{
	dir = 4
	},
/turf/open/floor/mineral/titanium/tiled,
/area/template_noop)
"nv" = (
/obj/effect/turf_decal/tile/brown{
	dir = 1
	},
/turf/open/floor/iron,
/area/template_noop)
"od" = (
/turf/open/floor/carpet/blue,
/area/template_noop)
"oe" = (
/obj/effect/spawner/structure/window/reinforced/shuttle,
/turf/open/floor/plating,
/area/template_noop)
"oj" = (
/obj/effect/turf_decal/tile/blue/anticorner/contrasted{
	dir = 4
	},
/turf/open/floor/iron,
/area/template_noop)
"or" = (
/obj/effect/turf_decal/siding/wood{
	dir = 8
	},
/turf/open/floor/wood,
/area/template_noop)
"oZ" = (
/obj/effect/turf_decal/stripes/line{
	dir = 6
	},
/turf/open/floor/plating/ocean_plating,
/area/template_noop)
"pi" = (
/obj/effect/turf_decal/tile/brown/half/contrasted{
	dir = 1
	},
/turf/open/floor/mineral/titanium/tiled,
/area/template_noop)
"pm" = (
/turf/open/floor/carpet,
/area/template_noop)
"qw" = (
/obj/effect/turf_decal/tile/blue/anticorner/contrasted{
	dir = 1
	},
/turf/open/floor/mineral/titanium/tiled,
/area/template_noop)
"sq" = (
/obj/effect/turf_decal/tile/brown/full,
/turf/open/floor/iron/large,
/area/template_noop)
"sB" = (
/turf/open/floor/mineral/titanium/purple,
/area/template_noop)
"tp" = (
/obj/effect/turf_decal/tile/purple/half/contrasted,
/turf/open/floor/mineral/titanium/tiled,
/area/template_noop)
"tK" = (
/obj/effect/turf_decal/tile/brown{
	dir = 4
	},
/turf/open/floor/iron,
/area/template_noop)
"ug" = (
/obj/effect/turf_decal/tile/brown/half/contrasted{
	dir = 4
	},
/turf/open/floor/iron,
/area/template_noop)
"ui" = (
/turf/open/floor/plating/ocean_plating,
/area/template_noop)
"uJ" = (
/obj/effect/turf_decal/tile/blue/half/contrasted{
	dir = 4
	},
/turf/open/floor/iron,
/area/template_noop)
"uN" = (
/obj/effect/turf_decal/tile/yellow/full,
/turf/open/floor/iron/large,
/area/template_noop)
"uO" = (
/obj/structure/window/reinforced/spawner/directional/west,
/obj/machinery/power/shuttle_engine/heater{
	dir = 8
	},
/turf/open/floor/plating,
/area/template_noop)
"vC" = (
/obj/effect/turf_decal/tile/blue/anticorner/contrasted,
/turf/open/floor/iron,
/area/template_noop)
"vH" = (
/obj/effect/turf_decal/trimline/brown/filled/line{
	dir = 8
	},
/obj/effect/turf_decal/siding/thinplating_new{
	dir = 4
	},
/turf/open/floor/mineral/titanium/tiled,
/area/template_noop)
"wf" = (
/obj/effect/turf_decal/tile/yellow,
/turf/open/floor/mineral/titanium/tiled,
/area/template_noop)
"wD" = (
/turf/open/floor/mineral/titanium,
/area/template_noop)
"wK" = (
/obj/effect/turf_decal/trimline/blue/filled/line{
	dir = 1
	},
/obj/effect/turf_decal/trimline/blue/filled/mid_joiner{
	dir = 1
	},
/turf/open/floor/mineral/titanium,
/area/template_noop)
"xf" = (
/obj/effect/turf_decal/tile/brown{
	dir = 8
	},
/turf/open/floor/mineral/titanium/tiled,
/area/template_noop)
"xJ" = (
/obj/structure/window/reinforced/spawner/directional/east,
/obj/effect/turf_decal/tile/purple{
	dir = 8
	},
/turf/open/floor/iron,
/area/template_noop)
"yD" = (
/obj/effect/turf_decal/stripes/line{
	dir = 4
	},
/turf/open/floor/plating,
/area/template_noop)
"zj" = (
/obj/effect/turf_decal/tile/yellow{
	dir = 8
	},
/turf/open/floor/iron,
/area/template_noop)
"zw" = (
/obj/effect/turf_decal/stripes/line{
	dir = 1
	},
/turf/open/floor/plating,
/area/template_noop)
"zC" = (
/obj/effect/turf_decal/tile/brown/half/contrasted{
	dir = 8
	},
/turf/open/floor/iron,
/area/template_noop)
"Ac" = (
/obj/effect/turf_decal/tile/purple/half/contrasted,
/turf/open/floor/iron,
/area/template_noop)
"Af" = (
/obj/effect/turf_decal/trimline/yellow/filled/line,
/obj/effect/turf_decal/trimline/blue/filled/line{
	dir = 4
	},
/turf/open/floor/iron,
/area/template_noop)
"Bk" = (
/obj/effect/turf_decal/tile/blue/full,
/turf/open/floor/iron/large,
/area/template_noop)
"Cg" = (
/obj/effect/turf_decal/tile/brown/full,
/turf/open/floor/mineral/titanium,
/area/template_noop)
"Cj" = (
/obj/effect/turf_decal/trimline/yellow/filled/line{
	dir = 4
	},
/obj/effect/turf_decal/siding/thinplating_new{
	dir = 8
	},
/turf/open/floor/mineral/titanium/tiled,
/area/template_noop)
"Cu" = (
/obj/effect/turf_decal/trimline/brown/filled/line{
	dir = 1
	},
/turf/open/floor/iron,
/area/template_noop)
"CG" = (
/obj/effect/turf_decal/tile/purple/half/contrasted{
	dir = 8
	},
/turf/open/floor/iron,
/area/template_noop)
"CM" = (
/obj/effect/turf_decal/tile/green/full,
/turf/open/floor/mineral/titanium,
/area/template_noop)
"Ee" = (
/obj/effect/turf_decal/stripes/line{
	dir = 8
	},
/obj/effect/turf_decal/stripes/line{
	dir = 4
	},
/turf/open/floor/plating,
/area/template_noop)
"EF" = (
/obj/effect/turf_decal/tile/brown{
	dir = 1
	},
/turf/open/floor/mineral/titanium/tiled,
/area/template_noop)
"EI" = (
/turf/open/floor/iron,
/area/template_noop)
"EO" = (
/obj/effect/turf_decal/tile/purple/anticorner/contrasted{
	dir = 8
	},
/turf/open/floor/iron,
/area/template_noop)
"Fk" = (
/obj/effect/turf_decal/stripes/line,
/turf/open/floor/plating,
/area/template_noop)
"FM" = (
/obj/effect/turf_decal/tile/purple/anticorner/contrasted,
/turf/open/floor/mineral/titanium/tiled,
/area/template_noop)
"Hv" = (
/obj/effect/turf_decal/tile/yellow{
	dir = 4
	},
/turf/open/floor/iron,
/area/template_noop)
"Hw" = (
/turf/open/floor/mineral/titanium/blue,
/area/template_noop)
"HA" = (
/obj/effect/turf_decal/stripes/line{
	dir = 5
	},
/turf/open/floor/plating/ocean_plating,
/area/template_noop)
"IV" = (
/obj/effect/turf_decal/stripes/line,
/turf/open/floor/plating/ocean_plating,
/area/template_noop)
"Ja" = (
/obj/effect/turf_decal/stripes/line{
	dir = 10
	},
/turf/open/floor/plating/ocean_plating,
/area/template_noop)
"JR" = (
/obj/effect/turf_decal/trimline/blue/filled/line{
	dir = 4
	},
/obj/effect/turf_decal/trimline/blue/filled/mid_joiner{
	dir = 4
	},
/turf/open/floor/iron/large,
/area/template_noop)
"KN" = (
/obj/effect/turf_decal/trimline/purple/filled/line{
	dir = 4
	},
/obj/effect/turf_decal/siding/thinplating_new{
	dir = 8
	},
/turf/open/floor/mineral/titanium/tiled,
/area/template_noop)
"Me" = (
/obj/effect/turf_decal/trimline/yellow/filled/line,
/turf/open/floor/iron,
/area/template_noop)
"Mk" = (
/obj/machinery/power/shuttle_engine/propulsion{
	dir = 8
	},
/turf/open/floor/plating/ocean_plating,
/area/template_noop)
"Mw" = (
/obj/structure/window/reinforced/spawner/directional/north,
/obj/effect/turf_decal/tile/purple,
/turf/open/floor/mineral/titanium/tiled,
/area/template_noop)
"MO" = (
/obj/effect/turf_decal/tile/blue/anticorner/contrasted{
	dir = 4
	},
/turf/open/floor/mineral/titanium/tiled,
/area/template_noop)
"NV" = (
/obj/effect/turf_decal/trimline/green/filled/line{
	dir = 8
	},
/obj/effect/turf_decal/siding/thinplating_new{
	dir = 4
	},
/turf/open/floor/mineral/titanium/tiled,
/area/template_noop)
"Oo" = (
/obj/effect/turf_decal/tile/brown/half/contrasted,
/turf/open/floor/mineral/titanium/tiled,
/area/template_noop)
"OA" = (
/turf/closed/wall,
/area/template_noop)
"Qa" = (
/obj/effect/turf_decal/stripes/line{
	dir = 4
	},
/turf/open/floor/plating/ocean_plating,
/area/template_noop)
"Rd" = (
/obj/effect/turf_decal/trimline/brown/filled/line{
	dir = 1
	},
/obj/effect/turf_decal/trimline/blue/filled/line{
	dir = 4
	},
/turf/open/floor/iron,
/area/template_noop)
"Rv" = (
/obj/effect/turf_decal/stripes/line{
	dir = 9
	},
/turf/open/floor/plating/ocean_plating,
/area/template_noop)
"Rx" = (
/turf/closed/wall/mineral/titanium/nodiagonal,
/area/template_noop)
"RE" = (
/obj/structure/window/reinforced/spawner/directional/east,
/turf/open/floor/iron,
/area/template_noop)
"UJ" = (
/obj/effect/turf_decal/trimline/brown/filled/line{
	dir = 8
	},
/obj/effect/turf_decal/trimline/blue/filled/line{
	dir = 1
	},
/obj/effect/turf_decal/siding/thinplating_new{
	dir = 4
	},
/turf/open/floor/mineral/titanium/tiled,
/area/template_noop)
"Wk" = (
/obj/effect/turf_decal/stripes/line{
	dir = 1
	},
/turf/open/floor/plating/ocean_plating,
/area/template_noop)
"Xh" = (
/obj/effect/turf_decal/tile/purple/full,
/turf/open/floor/iron/large,
/area/template_noop)
"Xi" = (
/obj/effect/turf_decal/stripes/line{
	dir = 8
	},
/turf/open/floor/plating,
/area/template_noop)
"Zu" = (
/obj/effect/turf_decal/stripes/line{
	dir = 8
	},
/turf/open/floor/plating/ocean_plating,
/area/template_noop)

(1,1,1) = {"
eh
eh
eh
eh
eh
eh
OA
Mk
Mk
Mk
OA
eh
eh
eh
eh
eh
eh
eh
eh
eh
eh
"}
(2,1,1) = {"
eh
eh
eh
eh
OA
Mk
OA
uO
uO
uO
OA
Mk
OA
eh
eh
eh
eh
eh
eh
eh
eh
"}
(3,1,1) = {"
eh
eh
eh
eh
OA
uO
OA
hG
hG
hG
OA
uO
OA
eh
eh
eh
eh
eh
eh
eh
eh
"}
(4,1,1) = {"
eh
eh
eh
OA
OA
hG
hG
hG
hG
hG
hG
hG
OA
OA
eh
eh
eh
eh
eh
eh
eh
"}
(5,1,1) = {"
eh
eh
eh
OA
hG
hG
hG
hG
hG
hG
hG
hG
hG
OA
eh
eh
eh
eh
eh
eh
eh
"}
(6,1,1) = {"
eh
eh
OA
OA
OA
OA
OA
OA
yD
OA
OA
OA
OA
OA
OA
eh
eh
eh
eh
eh
eh
"}
(7,1,1) = {"
eh
eh
OA
pm
pm
pm
OA
bP
aS
ao
OA
CG
CG
EO
OA
eh
eh
eh
eh
eh
eh
"}
(8,1,1) = {"
eh
eh
OA
pm
pm
pm
kD
bP
aS
ao
Xh
EI
EI
Ac
OA
eh
eh
eh
eh
eh
eh
"}
(9,1,1) = {"
eh
Rv
OA
or
or
or
OA
bP
aS
ao
OA
EI
EI
Ac
OA
Ja
eh
eh
eh
eh
eh
"}
(10,1,1) = {"
eh
Wk
OA
OA
OA
OA
OA
bP
aS
ao
OA
RE
EI
xJ
OA
IV
eh
eh
eh
eh
eh
"}
(11,1,1) = {"
Rv
Zu
aQ
zC
zC
nv
cK
Cu
aS
Me
OA
EI
EI
zw
OA
OA
OA
eh
eh
eh
eh
"}
(12,1,1) = {"
Wk
ui
aQ
EI
EI
EI
OA
Cu
aS
Me
uN
zj
Hv
zw
hG
hG
Fk
eh
eh
eh
eh
"}
(13,1,1) = {"
HA
Qa
aQ
ug
ug
tK
sq
Rd
JR
Af
OA
EI
EI
zw
OA
OA
OA
eh
eh
eh
eh
"}
(14,1,1) = {"
eh
eh
OA
OA
OA
Xi
OA
OA
Bk
OA
OA
Xi
OA
OA
OA
eh
eh
eh
eh
eh
eh
"}
(15,1,1) = {"
eh
eh
eh
OA
hG
hG
OA
EI
EI
EI
OA
hG
hG
OA
eh
eh
eh
eh
eh
eh
eh
"}
(16,1,1) = {"
eh
eh
eh
OA
OA
hG
Fk
EI
EI
EI
zw
hG
OA
OA
eh
eh
eh
eh
eh
eh
eh
"}
(17,1,1) = {"
eh
eh
eh
eh
OA
OA
OA
oj
uJ
vC
OA
OA
OA
eh
eh
eh
eh
eh
eh
eh
eh
"}
(18,1,1) = {"
eh
eh
eh
eh
eh
eh
OA
eA
eA
eA
OA
eh
eh
eh
eh
eh
eh
eh
eh
eh
eh
"}
(19,1,1) = {"
eh
eh
eh
eh
eh
eh
eh
eh
eh
eh
eh
eh
eh
eh
eh
eh
eh
eh
eh
eh
eh
"}
(20,1,1) = {"
eh
eh
eh
eh
eh
eh
eh
eh
Rv
Zu
Ja
eh
eh
eh
eh
eh
eh
eh
eh
eh
eh
"}
(21,1,1) = {"
eh
eh
eh
eh
eh
eh
eh
eh
Wk
ui
IV
Zu
Ja
eh
eh
eh
eh
eh
eh
eh
eh
"}
(22,1,1) = {"
eh
eh
eh
eh
eh
eh
eh
Rx
Ee
Ee
Ee
Rx
Rx
Rx
Rx
Rx
eh
eh
eh
eh
eh
"}
(23,1,1) = {"
eh
eh
eh
eh
eh
Rx
Rx
Rx
pi
kS
Oo
Rx
hc
od
od
Rx
Rx
Rx
eh
eh
eh
"}
(24,1,1) = {"
eh
eh
eh
eh
Rx
Rx
hG
Rx
pi
kS
Oo
Rx
hc
od
od
Rx
hG
Rx
Rx
Rx
eh
"}
(25,1,1) = {"
eh
eh
eh
eh
Rx
hG
hG
Fk
EF
kS
xf
Rx
hc
od
od
Rx
hG
hG
fR
fB
eh
"}
(26,1,1) = {"
eh
eh
eh
Rx
Rx
yD
Rx
Rx
Cg
Rx
cK
Rx
Rx
CM
Rx
Rx
hG
hG
Rx
Rx
Rx
"}
(27,1,1) = {"
eh
eh
eh
oe
qw
kS
kS
Rx
UJ
vH
vH
NV
NV
NV
NV
Rx
hG
hG
hG
fR
fB
"}
(28,1,1) = {"
eh
eh
eh
oe
bO
kS
kS
Hw
wK
wD
wD
wD
wD
wD
wD
zw
hG
hG
hG
fR
fB
"}
(29,1,1) = {"
eh
eh
eh
oe
MO
kS
kS
Rx
eo
Cj
Cj
KN
KN
KN
KN
Rx
hG
hG
hG
fR
fB
"}
(30,1,1) = {"
eh
eh
eh
Rx
Rx
Xi
Rx
Rx
Rx
dQ
Rx
Rx
Rx
sB
Rx
Rx
hG
hG
Rx
Rx
Rx
"}
(31,1,1) = {"
eh
eh
eh
eh
Rx
hG
hG
Fk
kS
wf
kS
ld
kS
kS
tp
Rx
hG
hG
fR
fB
eh
"}
(32,1,1) = {"
eh
eh
eh
eh
Rx
Rx
hG
Rx
kS
dl
kS
kS
kS
kS
tp
Rx
hG
Rx
Rx
Rx
eh
"}
(33,1,1) = {"
eh
eh
eh
eh
eh
Rx
Rx
Rx
Xi
Xi
Xi
Mw
lt
lt
FM
Rx
Rx
Rx
eh
eh
eh
"}
(34,1,1) = {"
eh
eh
eh
eh
eh
eh
eh
Rx
Rx
hG
Rx
Rx
Rx
Rx
Rx
Rx
eh
eh
eh
eh
eh
"}
(35,1,1) = {"
eh
eh
eh
eh
eh
eh
eh
eh
Rx
hG
Rx
Qa
oZ
eh
eh
eh
eh
eh
eh
eh
eh
"}
(36,1,1) = {"
eh
eh
eh
eh
eh
eh
eh
eh
Rx
yD
Rx
eh
eh
eh
eh
eh
eh
eh
eh
eh
eh
"}
