//MAP CONVERTED BY dmm2tgm.py THIS HEADER COMMENT PREVENTS RECONVERSION, DO NOT REMOVE
"ad" = (
/obj/effect/turf_decal/tile/blue/opposingcorners{
	dir = 1
	},
/obj/machinery/atmospherics/components/unary/vent_scrubber/on/layer2{
	dir = 1
	},
/turf/open/floor/iron/cafeteria,
/area/station/commons/dorms/laundry)
"az" = (
/obj/machinery/airalarm/directional/west,
/obj/machinery/atmospherics/pipe/smart/manifold4w/scrubbers/hidden/layer2,
/turf/open/floor/wood,
/area/station/service/studio)
"aU" = (
/obj/structure/closet,
/obj/item/clothing/under/suit/black,
/obj/item/clothing/under/rank/civilian/lawyer/black/skirt,
/obj/effect/turf_decal/tile/blue/opposingcorners{
	dir = 1
	},
/turf/open/floor/iron/cafeteria,
/area/station/commons/dorms/laundry)
"bv" = (
/obj/effect/turf_decal/tile/blue/opposingcorners{
	dir = 1
	},
/obj/machinery/airalarm/directional/south,
/obj/structure/table,
/obj/item/toy/foamblade,
/obj/effect/spawner/random/clothing/kittyears_or_rabbitears,
/turf/open/floor/iron/cafeteria,
/area/station/commons/dorms/laundry)
"by" = (
/turf/closed/wall,
/area/station/service/studio)
"bR" = (
/obj/effect/turf_decal/tile/blue/opposingcorners{
	dir = 1
	},
/obj/structure/closet,
/turf/open/floor/iron/cafeteria,
/area/station/commons/dorms/laundry)
"cy" = (
/obj/structure/table,
/obj/machinery/button/showtime/broadcast_team,
/obj/item/reagent_containers/cup/glass/waterbottle{
	pixel_y = 12;
	pixel_x = -8
	},
/turf/open/floor/iron/dark,
/area/station/service/studio)
"ea" = (
/obj/structure/cable,
/obj/machinery/atmospherics/pipe/smart/manifold4w/supply/hidden/layer4,
/turf/open/floor/iron/dark,
/area/station/service/studio)
"ej" = (
/obj/machinery/door/airlock/maintenance,
/obj/structure/cable,
/obj/machinery/atmospherics/pipe/smart/manifold4w/supply/hidden/layer4,
/obj/machinery/atmospherics/pipe/smart/manifold4w/scrubbers/hidden/layer2,
/obj/structure/disposalpipe/segment{
	dir = 4
	},
/obj/effect/mapping_helpers/airlock/access/all/engineering/maintenance,
/turf/open/floor/plating,
/area/station/maintenance/port/greater)
"eF" = (
/obj/machinery/atmospherics/pipe/smart/manifold4w/supply/hidden/layer4,
/obj/machinery/atmospherics/pipe/smart/manifold4w/scrubbers/hidden/layer2,
/turf/open/floor/wood,
/area/station/service/studio)
"gw" = (
/obj/structure/closet/crate,
/obj/item/vending_refill/lustwish,
/obj/item/stack/cable_coil/five,
/turf/open/floor/plating,
/area/station/service/studio)
"gA" = (
/turf/template_noop,
/area/template_noop)
"gG" = (
/obj/structure/chair/plastic{
	dir = 1
	},
/obj/machinery/atmospherics/pipe/smart/manifold4w/supply/hidden/layer4,
/obj/machinery/atmospherics/pipe/smart/manifold4w/scrubbers/hidden/layer2,
/obj/effect/landmark/start/broadcast_team,
/turf/open/floor/iron/dark,
/area/station/service/studio)
"gZ" = (
/obj/item/radio/intercom/broadcast/directional/west,
/turf/open/floor/iron,
/area/station/service/studio/stage)
"ha" = (
/obj/effect/turf_decal/tile/blue/opposingcorners{
	dir = 1
	},
/obj/structure/table,
/obj/item/storage/crayons,
/turf/open/floor/iron/cafeteria,
/area/station/commons/dorms/laundry)
"hc" = (
/obj/effect/turf_decal/tile/blue/opposingcorners{
	dir = 1
	},
/obj/machinery/atmospherics/components/unary/vent_pump/on/layer4{
	dir = 1
	},
/turf/open/floor/iron/cafeteria,
/area/station/commons/dorms/laundry)
"hx" = (
/obj/machinery/airalarm/directional/west,
/obj/machinery/atmospherics/pipe/smart/manifold4w/supply/hidden/layer4,
/turf/open/floor/iron/freezer,
/area/station/service/studio)
"iL" = (
/obj/effect/turf_decal/tile/blue/opposingcorners{
	dir = 1
	},
/obj/machinery/light/directional/east,
/turf/open/floor/iron/cafeteria,
/area/station/commons/dorms/laundry)
"iR" = (
/obj/structure/table,
/obj/effect/spawner/random/engineering/material,
/obj/effect/spawner/random/engineering/material_cheap,
/obj/effect/spawner/random/decoration/generic,
/turf/open/floor/iron/dark,
/area/station/service/studio)
"jg" = (
/obj/effect/turf_decal/tile/blue/opposingcorners{
	dir = 1
	},
/obj/item/kirbyplants/random,
/turf/open/floor/iron/cafeteria,
/area/station/commons/dorms/laundry)
"kb" = (
/obj/machinery/vending/autodrobe,
/obj/machinery/light/small/directional/east,
/turf/open/floor/iron/dark/herringbone,
/area/station/service/studio)
"kI" = (
/obj/effect/turf_decal/tile/blue/opposingcorners{
	dir = 1
	},
/obj/effect/spawner/random/entertainment/arcade{
	dir = 4
	},
/turf/open/floor/iron/cafeteria,
/area/station/commons/dorms/laundry)
"lq" = (
/obj/structure/chair/plastic{
	dir = 1
	},
/obj/machinery/atmospherics/pipe/smart/manifold4w/supply/hidden/layer4,
/obj/effect/landmark/start/broadcast_team,
/turf/open/floor/iron/dark,
/area/station/service/studio)
"lQ" = (
/obj/effect/spawner/structure/window/reinforced/tinted,
/turf/open/floor/plating,
/area/station/service/studio)
"mi" = (
/obj/effect/turf_decal/tile/blue/opposingcorners{
	dir = 1
	},
/obj/machinery/light/directional/south,
/obj/structure/table,
/obj/item/rcl/pre_loaded,
/turf/open/floor/iron/cafeteria,
/area/station/commons/dorms/laundry)
"mo" = (
/obj/effect/turf_decal/tile/blue/opposingcorners{
	dir = 1
	},
/turf/open/floor/iron/cafeteria,
/area/station/commons/dorms/laundry)
"mr" = (
/obj/machinery/camera/broadcast/directional/north{
	view_range = 4
	},
/turf/open/floor/iron,
/area/station/service/studio/stage)
"mX" = (
/obj/structure/cable,
/obj/machinery/atmospherics/pipe/smart/manifold4w/supply/hidden/layer4,
/obj/machinery/atmospherics/pipe/smart/manifold4w/scrubbers/hidden/layer2,
/obj/effect/turf_decal/tile/blue/opposingcorners{
	dir = 1
	},
/obj/structure/disposalpipe/segment{
	dir = 10
	},
/turf/open/floor/iron/cafeteria,
/area/station/commons/dorms/laundry)
"nR" = (
/obj/effect/spawner/structure/window/hollow/reinforced/middle{
	dir = 1
	},
/turf/open/floor/plating,
/area/station/commons/dorms/laundry)
"of" = (
/obj/effect/landmark/event_spawn,
/obj/effect/turf_decal/tile/blue/opposingcorners{
	dir = 1
	},
/turf/open/floor/iron/cafeteria,
/area/station/commons/dorms/laundry)
"os" = (
/obj/machinery/shower/directional/south,
/obj/structure/drain,
/obj/structure/curtain,
/turf/open/floor/iron/freezer,
/area/station/service/studio)
"pg" = (
/obj/machinery/camera/emp_proof/directional/south,
/obj/effect/turf_decal/tile/blue/opposingcorners{
	dir = 1
	},
/obj/structure/chair/stool/directional/west,
/turf/open/floor/iron/cafeteria,
/area/station/commons/dorms/laundry)
"pN" = (
/obj/machinery/washing_machine,
/obj/structure/sign/poster/official/random/directional/north,
/obj/effect/turf_decal/tile/blue/opposingcorners{
	dir = 1
	},
/turf/open/floor/iron/cafeteria,
/area/station/commons/dorms/laundry)
"rp" = (
/obj/effect/landmark/atmospheric_sanity/ignore_area,
/turf/open/floor/iron,
/area/station/service/studio/stage)
"rZ" = (
/obj/effect/landmark/start/broadcast_team,
/turf/open/floor/iron,
/area/station/service/studio/stage)
"sB" = (
/obj/machinery/rnd/production/circuit_imprinter,
/turf/open/floor/iron/dark/herringbone,
/area/station/service/studio)
"sW" = (
/obj/effect/turf_decal/siding/dark{
	dir = 8
	},
/turf/open/floor/iron/dark/herringbone,
/area/station/service/studio)
"ud" = (
/obj/structure/cable,
/obj/machinery/atmospherics/pipe/smart/manifold4w/supply/hidden/layer4,
/obj/effect/turf_decal/tile/blue/opposingcorners{
	dir = 1
	},
/turf/open/floor/iron/cafeteria,
/area/station/commons/dorms/laundry)
"wb" = (
/obj/structure/cable/multilayer/multiz,
/turf/open/floor/plating,
/area/station/maintenance/port/greater)
"wH" = (
/obj/effect/turf_decal/tile/blue/opposingcorners{
	dir = 1
	},
/obj/machinery/disposal/bin,
/obj/structure/disposalpipe/trunk{
	dir = 1
	},
/turf/open/floor/iron/cafeteria,
/area/station/commons/dorms/laundry)
"xo" = (
/obj/effect/turf_decal/siding/wideplating_new,
/obj/effect/turf_decal/siding/wideplating_new{
	dir = 1
	},
/obj/machinery/door/airlock,
/obj/effect/mapping_helpers/airlock/access/all/service/studio,
/obj/effect/mapping_helpers/airlock/autoname,
/obj/structure/cable,
/obj/machinery/atmospherics/pipe/smart/manifold4w/supply/hidden/layer4,
/turf/open/floor/iron/diagonal,
/area/station/service/studio)
"zb" = (
/obj/machinery/power/floodlight,
/obj/structure/cable,
/turf/open/floor/catwalk_floor/iron_dark,
/area/station/service/studio)
"zf" = (
/obj/effect/turf_decal/siding/dark{
	dir = 8
	},
/obj/machinery/autolathe,
/obj/machinery/airalarm/directional/south,
/turf/open/floor/iron/dark/herringbone,
/area/station/service/studio)
"zn" = (
/obj/effect/turf_decal/siding/wideplating_new,
/obj/effect/turf_decal/siding/wideplating_new{
	dir = 1
	},
/obj/machinery/door/airlock,
/obj/effect/mapping_helpers/airlock/access/all/service/studio,
/obj/effect/mapping_helpers/airlock/autoname,
/obj/machinery/atmospherics/pipe/smart/manifold4w/scrubbers/hidden/layer2,
/obj/effect/landmark/navigate_destination,
/turf/open/floor/iron/diagonal,
/area/station/service/studio)
"zt" = (
/obj/effect/turf_decal/siding/wood{
	dir = 8
	},
/obj/effect/turf_decal/siding/wood{
	dir = 4
	},
/obj/machinery/door/airlock{
	id_tag = "dressingroombolts";
	name = "Dressing Room"
	},
/obj/machinery/atmospherics/pipe/smart/manifold4w/supply/hidden/layer4,
/obj/machinery/atmospherics/pipe/smart/manifold4w/scrubbers/hidden/layer2,
/obj/effect/mapping_helpers/airlock/access/all/service/studio,
/obj/effect/mapping_helpers/airlock/unres{
	dir = 8
	},
/turf/open/floor/wood/large,
/area/station/service/studio)
"AJ" = (
/obj/machinery/atmospherics/pipe/smart/manifold4w/supply/hidden/layer4,
/obj/machinery/atmospherics/components/unary/vent_scrubber/on/layer2,
/obj/machinery/light/small/directional/west,
/turf/open/floor/iron/freezer,
/area/station/service/studio)
"Bn" = (
/obj/structure/disposalpipe/trunk/multiz{
	dir = 1
	},
/obj/effect/spawner/random/trash/graffiti{
	pixel_y = -32;
	spawn_loot_chance = 50
	},
/obj/effect/mapping_helpers/burnt_floor,
/turf/open/floor/plating,
/area/station/maintenance/port/greater)
"Bq" = (
/obj/effect/turf_decal/tile/blue/opposingcorners{
	dir = 1
	},
/obj/machinery/atmospherics/pipe/smart/manifold4w/scrubbers/hidden/layer2,
/turf/open/floor/iron/cafeteria,
/area/station/commons/dorms/laundry)
"BL" = (
/obj/structure/toilet{
	pixel_y = 12
	},
/obj/machinery/atmospherics/components/unary/vent_pump/on/layer4{
	dir = 8
	},
/obj/effect/landmark/start/broadcast_team,
/turf/open/floor/iron/freezer,
/area/station/service/studio)
"BO" = (
/obj/effect/landmark/start/hangover,
/obj/effect/turf_decal/tile/blue/opposingcorners{
	dir = 1
	},
/turf/open/floor/iron/cafeteria,
/area/station/commons/dorms/laundry)
"Cg" = (
/obj/effect/turf_decal/tile/blue/opposingcorners{
	dir = 1
	},
/obj/structure/closet/crate/trashcart/laundry,
/obj/structure/railing{
	dir = 4
	},
/turf/open/floor/iron/cafeteria,
/area/station/commons/dorms/laundry)
"Cm" = (
/obj/structure/cable,
/obj/machinery/atmospherics/pipe/smart/manifold4w/supply/hidden/layer4,
/obj/machinery/atmospherics/pipe/smart/manifold4w/scrubbers/hidden/layer2,
/turf/open/floor/catwalk_floor/iron_dark,
/area/station/service/studio)
"Dh" = (
/obj/structure/table,
/obj/machinery/computer/security/telescreen/broadcast_team{
	dir = 4;
	pixel_y = 3
	},
/obj/machinery/atmospherics/pipe/smart/manifold4w/scrubbers/hidden/layer2,
/turf/open/floor/iron/dark,
/area/station/service/studio)
"DO" = (
/obj/effect/turf_decal/siding/dark{
	dir = 1
	},
/obj/machinery/atmospherics/components/unary/vent_pump/on/layer4,
/turf/open/floor/iron/dark,
/area/station/service/studio)
"Fh" = (
/turf/open/floor/iron/dark,
/area/station/service/studio)
"Fm" = (
/turf/closed/wall,
/area/station/commons/dorms/laundry)
"FR" = (
/obj/effect/turf_decal/siding/dark{
	dir = 1
	},
/obj/machinery/atmospherics/components/unary/vent_scrubber/on/layer2,
/turf/open/floor/iron/dark,
/area/station/service/studio)
"FW" = (
/obj/structure/stairs/south{
	dir = 1
	},
/turf/open/floor/iron,
/area/station/commons/dorms/laundry)
"GF" = (
/obj/machinery/atmospherics/pipe/smart/manifold4w/scrubbers/hidden/layer2,
/turf/open/floor/iron/dark,
/area/station/service/studio)
"HC" = (
/obj/structure/table,
/obj/item/storage/toolbox/mechanical{
	pixel_y = 10;
	pixel_x = 3
	},
/obj/item/storage/toolbox/mechanical{
	pixel_y = 5;
	pixel_x = 2
	},
/obj/item/multitool{
	pixel_x = -4
	},
/obj/item/multitool{
	pixel_x = 2
	},
/obj/effect/turf_decal/siding/dark/corner{
	dir = 4
	},
/turf/open/floor/iron/dark,
/area/station/service/studio)
"HP" = (
/obj/structure/chair/stool/bar/directional/north,
/obj/structure/mirror/directional/north,
/obj/effect/landmark/start/broadcast_team,
/turf/open/floor/wood,
/area/station/service/studio)
"HR" = (
/obj/structure/table,
/obj/machinery/cell_charger,
/obj/item/stack/cable_coil,
/obj/machinery/light/small/directional/west,
/turf/open/floor/iron/dark,
/area/station/service/studio)
"IH" = (
/obj/structure/cable,
/obj/machinery/atmospherics/pipe/smart/manifold4w/supply/hidden/layer4,
/obj/machinery/atmospherics/pipe/smart/manifold4w/scrubbers/hidden/layer2,
/turf/open/floor/iron/dark/herringbone,
/area/station/service/studio)
"LY" = (
/obj/effect/turf_decal/tile/blue/opposingcorners{
	dir = 1
	},
/obj/effect/landmark/start/hangover,
/turf/open/floor/iron/cafeteria,
/area/station/commons/dorms/laundry)
"Ma" = (
/obj/effect/turf_decal/siding/dark,
/obj/effect/turf_decal/trimline/dark/warning{
	dir = 1
	},
/obj/machinery/door/airlock/silver{
	name = "Bathroom";
	id_tag = "broadcastbathroom"
	},
/obj/machinery/atmospherics/pipe/smart/manifold4w/supply/hidden/layer4,
/obj/machinery/atmospherics/pipe/smart/manifold4w/scrubbers/hidden/layer2,
/turf/open/floor/iron/freezer,
/area/station/service/studio)
"MU" = (
/obj/structure/chair/office{
	dir = 1
	},
/obj/effect/landmark/start/broadcast_team,
/obj/structure/cable,
/obj/machinery/atmospherics/pipe/smart/manifold4w/supply/hidden/layer4,
/obj/machinery/atmospherics/pipe/smart/manifold4w/scrubbers/hidden/layer2,
/turf/open/floor/iron/dark,
/area/station/service/studio)
"Na" = (
/obj/machinery/computer/camera_advanced/base_construction/broadcast,
/turf/open/floor/iron/dark,
/area/station/service/studio)
"Nf" = (
/obj/structure/cable,
/obj/machinery/power/apc/auto_name/directional/east,
/turf/open/floor/iron/dark/herringbone,
/area/station/service/studio)
"Nh" = (
/obj/effect/turf_decal/siding/dark{
	dir = 1
	},
/turf/open/floor/iron/dark,
/area/station/service/studio)
"NH" = (
/turf/closed/wall,
/area/station/maintenance/port/greater)
"NV" = (
/obj/item/radio/intercom/broadcast/directional/east,
/turf/open/floor/iron,
/area/station/service/studio/stage)
"Od" = (
/obj/machinery/atmospherics/pipe/smart/manifold4w/supply/hidden/layer4,
/obj/machinery/atmospherics/pipe/smart/manifold4w/scrubbers/hidden/layer2,
/turf/open/floor/iron/dark,
/area/station/service/studio)
"Pg" = (
/obj/structure/cable,
/obj/machinery/atmospherics/pipe/smart/manifold4w/supply/hidden/layer4,
/obj/effect/turf_decal/siding/thinplating/corner{
	dir = 4
	},
/obj/machinery/power/apc/auto_name/directional/north,
/obj/effect/turf_decal/tile/blue/opposingcorners{
	dir = 1
	},
/turf/open/floor/iron/cafeteria,
/area/station/commons/dorms/laundry)
"Pq" = (
/obj/structure/cable,
/obj/machinery/atmospherics/pipe/smart/manifold4w/supply/hidden/layer4,
/obj/machinery/atmospherics/pipe/smart/manifold4w/scrubbers/hidden/layer2,
/obj/structure/disposalpipe/segment{
	dir = 6
	},
/obj/machinery/light/small/directional/north,
/obj/effect/spawner/random/structure/steam_vent,
/obj/effect/mapping_helpers/burnt_floor,
/turf/open/floor/plating,
/area/station/maintenance/port/greater)
"PG" = (
/obj/machinery/door/airlock/maintenance,
/obj/effect/mapping_helpers/airlock/access/all/engineering/external,
/turf/open/floor/plating,
/area/station/commons/dorms/laundry)
"PS" = (
/obj/structure/dresser,
/turf/open/floor/wood,
/area/station/service/studio)
"Rv" = (
/turf/open/floor/iron,
/area/station/service/studio/stage)
"RF" = (
/obj/machinery/atmospherics/pipe/smart/manifold4w/supply/hidden/layer4,
/turf/open/floor/iron/dark,
/area/station/service/studio)
"RG" = (
/obj/machinery/button/door/directional/south{
	normaldoorcontrol = 1;
	specialfunctions = 4;
	id = "broadcastbathroom";
	name = "Bolt Control"
	},
/obj/structure/sink/directional/west,
/obj/structure/mirror/directional/east,
/turf/open/floor/iron/freezer,
/area/station/service/studio)
"Sm" = (
/obj/structure/cable,
/obj/machinery/atmospherics/pipe/smart/manifold4w/supply/hidden/layer4,
/obj/machinery/atmospherics/pipe/smart/manifold4w/scrubbers/hidden/layer2,
/obj/effect/turf_decal/tile/blue/opposingcorners{
	dir = 1
	},
/turf/open/floor/iron/cafeteria,
/area/station/commons/dorms/laundry)
"TU" = (
/obj/effect/decal/cleanable/dirt,
/obj/effect/turf_decal/tile/blue/opposingcorners{
	dir = 1
	},
/turf/open/floor/iron/cafeteria,
/area/station/commons/dorms/laundry)
"Ue" = (
/obj/structure/table,
/obj/structure/bedsheetbin,
/obj/machinery/light/directional/north,
/obj/effect/turf_decal/tile/blue/opposingcorners{
	dir = 1
	},
/obj/machinery/atmospherics/pipe/smart/manifold4w/supply/hidden/layer4,
/turf/open/floor/iron/cafeteria,
/area/station/commons/dorms/laundry)
"Vr" = (
/obj/structure/rack,
/obj/machinery/atmospherics/components/unary/vent_scrubber/on/layer2{
	dir = 1
	},
/obj/machinery/light/small/directional/south,
/turf/open/floor/wood,
/area/station/service/studio)
"VD" = (
/obj/structure/cable,
/obj/machinery/atmospherics/pipe/smart/manifold4w/supply/hidden/layer4,
/obj/machinery/atmospherics/pipe/smart/manifold4w/scrubbers/hidden/layer2,
/turf/open/floor/iron/dark,
/area/station/service/studio)
"VY" = (
/obj/effect/turf_decal/tile/blue/opposingcorners{
	dir = 1
	},
/obj/structure/chair/stool/directional/west,
/turf/open/floor/iron/cafeteria,
/area/station/commons/dorms/laundry)
"Wh" = (
/obj/machinery/light/directional/south,
/obj/effect/turf_decal/tile/blue/opposingcorners{
	dir = 1
	},
/obj/structure/closet,
/turf/open/floor/iron/cafeteria,
/area/station/commons/dorms/laundry)
"Ws" = (
/obj/item/kirbyplants/random,
/obj/machinery/light/small/directional/south,
/turf/open/floor/iron/dark,
/area/station/service/studio)
"WF" = (
/obj/machinery/button/door/directional/east{
	normaldoorcontrol = 1;
	specialfunctions = 4;
	id = "dressingroombolts";
	name = "Bolt Control"
	},
/obj/structure/chair/stool/bar/directional/north,
/obj/structure/mirror/directional/north,
/obj/machinery/atmospherics/components/unary/vent_pump/on/layer4,
/obj/effect/landmark/start/broadcast_team,
/turf/open/floor/wood,
/area/station/service/studio)
"Xi" = (
/obj/machinery/vending/clothing,
/turf/open/floor/iron/dark/herringbone,
/area/station/service/studio)
"Xk" = (
/obj/machinery/atmospherics/pipe/smart/manifold4w/supply/hidden/layer4,
/obj/machinery/atmospherics/pipe/smart/manifold4w/scrubbers/hidden/layer2,
/turf/open/floor/iron/dark/herringbone,
/area/station/service/studio)
"XH" = (
/obj/effect/turf_decal/siding/thinplating{
	dir = 1
	},
/obj/effect/turf_decal/tile/blue/opposingcorners{
	dir = 1
	},
/obj/machinery/atmospherics/pipe/smart/manifold4w/supply/hidden/layer4,
/turf/open/floor/iron/cafeteria,
/area/station/commons/dorms/laundry)
"YG" = (
/obj/machinery/atmospherics/pipe/multiz/scrubbers/visible/layer2{
	color = "#ff0000";
	dir = 4;
	name = "Scrubbers multi deck pipe adapter"
	},
/obj/machinery/atmospherics/pipe/multiz/supply/visible/layer4{
	color = "#0000ff";
	dir = 4;
	name = "Supply multi deck pipe adapter"
	},
/obj/structure/cable,
/obj/effect/mapping_helpers/burnt_floor,
/turf/open/floor/plating,
/area/station/maintenance/port/greater)
"YL" = (
/obj/effect/turf_decal/siding/dark{
	dir = 8
	},
/obj/structure/cable,
/obj/machinery/atmospherics/pipe/smart/manifold4w/supply/hidden/layer4,
/obj/machinery/atmospherics/pipe/smart/manifold4w/scrubbers/hidden/layer2,
/turf/open/floor/iron/dark/herringbone,
/area/station/service/studio)
"Zt" = (
/obj/effect/turf_decal/siding/thinplating/corner{
	dir = 1
	},
/obj/machinery/washing_machine,
/obj/effect/turf_decal/tile/blue/opposingcorners{
	dir = 1
	},
/obj/machinery/atmospherics/pipe/smart/manifold4w/supply/hidden/layer4,
/turf/open/floor/iron/cafeteria,
/area/station/commons/dorms/laundry)

(1,1,1) = {"
gA
gA
gA
gA
gA
gA
gA
gA
gA
gA
gA
gA
NH
NH
NH
NH
gA
gA
"}
(2,1,1) = {"
gA
gA
gA
gA
gA
gA
gA
gA
by
by
by
by
NH
YG
wb
NH
gA
gA
"}
(3,1,1) = {"
gA
gA
gA
gA
gA
gA
by
by
by
HP
az
Vr
NH
Pq
Bn
NH
gA
gA
"}
(4,1,1) = {"
gA
gA
gA
gA
gA
gA
by
gw
by
WF
eF
PS
NH
ej
NH
NH
gA
gA
"}
(5,1,1) = {"
gA
gA
gA
gA
gA
by
by
by
by
by
zt
by
by
mX
wH
Fm
Fm
gA
"}
(6,1,1) = {"
by
by
by
by
by
by
HC
iR
HR
Fh
Od
Fh
by
Sm
mo
kI
Fm
Fm
"}
(7,1,1) = {"
by
rp
Rv
gZ
Rv
Rv
FR
GF
GF
GF
gG
GF
zn
Sm
LY
VY
bv
Fm
"}
(8,1,1) = {"
by
Rv
Rv
Rv
rZ
Rv
Nh
cy
Dh
Fh
lq
Fh
lQ
Sm
Bq
ad
mi
Fm
"}
(9,1,1) = {"
by
mr
rZ
Rv
Rv
Rv
Nh
Na
MU
ea
ea
ea
xo
ud
mo
mo
ha
Fm
"}
(10,1,1) = {"
by
Rv
Rv
Rv
rZ
Rv
Nh
zb
Cm
Fh
Fh
Ws
by
ud
BO
mo
pg
Fm
"}
(11,1,1) = {"
by
Rv
Rv
NV
Rv
Rv
DO
RF
VD
Fh
Fh
by
by
Pg
mo
mo
jg
nR
"}
(12,1,1) = {"
by
by
by
by
by
by
by
sW
YL
sW
zf
by
FW
XH
mo
TU
bR
nR
"}
(13,1,1) = {"
gA
gA
by
os
hx
AJ
Ma
Xk
IH
Nf
sB
by
FW
XH
mo
of
Wh
nR
"}
(14,1,1) = {"
gA
gA
by
by
BL
RG
by
Xi
kb
by
by
by
Fm
Zt
mo
BO
aU
nR
"}
(15,1,1) = {"
gA
gA
gA
by
by
by
by
by
by
by
gA
gA
Fm
Ue
hc
mo
Cg
Fm
"}
(16,1,1) = {"
gA
gA
gA
gA
gA
gA
gA
gA
gA
gA
gA
gA
Fm
pN
TU
iL
mo
PG
"}
(17,1,1) = {"
gA
gA
gA
gA
gA
gA
gA
gA
gA
gA
gA
gA
Fm
Fm
Fm
Fm
Fm
Fm
"}
