//MAP CONVERTED BY dmm2tgm.py THIS HEADER COMMENT PREVENTS RECONVERSION, DO NOT REMOVE
"a" = (
/turf/open/openspace,
/area/station/commons/fitness)
"e" = (
/obj/structure/cable,
/obj/machinery/atmospherics/pipe/smart/manifold4w/scrubbers/hidden/layer2,
/obj/machinery/atmospherics/pipe/smart/manifold4w/supply/hidden/layer4,
/obj/effect/turf_decal/siding/white{
	dir = 4
	},
/obj/structure/railing{
	dir = 4
	},
/obj/machinery/door/firedoor/border_only{
	dir = 4
	},
/turf/open/floor/iron,
/area/station/commons/fitness)
"h" = (
/obj/effect/turf_decal/siding/white/corner{
	dir = 8
	},
/obj/structure/railing/corner{
	dir = 8
	},
/turf/open/floor/iron,
/area/station/commons/fitness)
"i" = (
/obj/machinery/atmospherics/components/unary/vent_scrubber/on/layer2{
	dir = 8
	},
/obj/effect/turf_decal/siding/white/corner,
/obj/structure/railing/corner,
/turf/open/floor/iron,
/area/station/commons/fitness)
"j" = (
/obj/effect/turf_decal/siding/white{
	dir = 4
	},
/obj/machinery/door/firedoor/border_only{
	dir = 4
	},
/turf/open/floor/iron,
/area/station/commons/fitness)
"k" = (
/obj/machinery/holopad,
/obj/machinery/atmospherics/pipe/smart/manifold4w/scrubbers/hidden/layer2,
/obj/machinery/atmospherics/pipe/smart/manifold4w/supply/hidden/layer4,
/obj/effect/turf_decal/siding/white{
	dir = 4
	},
/obj/structure/railing{
	dir = 4
	},
/obj/machinery/door/firedoor/border_only{
	dir = 4
	},
/turf/open/floor/iron,
/area/station/commons/fitness)
"m" = (
/obj/structure/disposalpipe/segment{
	dir = 10
	},
/obj/machinery/atmospherics/pipe/smart/manifold4w/scrubbers/hidden/layer2,
/obj/machinery/atmospherics/pipe/smart/manifold4w/supply/hidden/layer4,
/obj/effect/turf_decal/siding/white{
	dir = 1
	},
/obj/structure/railing{
	dir = 1
	},
/obj/machinery/door/firedoor/border_only{
	dir = 1
	},
/turf/open/floor/iron,
/area/station/commons/fitness)
"o" = (
/obj/effect/turf_decal/tile/neutral/anticorner/contrasted,
/turf/open/floor/iron,
/area/station/commons/fitness)
"p" = (
/obj/structure/disposalpipe/segment{
	dir = 4
	},
/obj/structure/cable,
/obj/machinery/atmospherics/pipe/smart/manifold4w/scrubbers/hidden/layer2,
/obj/machinery/atmospherics/pipe/smart/manifold4w/supply/hidden/layer4,
/obj/effect/turf_decal/tile/neutral{
	dir = 8
	},
/obj/effect/turf_decal/siding/white/corner{
	dir = 4
	},
/obj/structure/railing/corner{
	dir = 4
	},
/turf/open/floor/iron,
/area/station/commons/fitness)
"u" = (
/obj/effect/turf_decal/siding/white/corner{
	dir = 1
	},
/obj/structure/railing/corner{
	dir = 1
	},
/turf/open/floor/iron,
/area/station/commons/fitness)
"y" = (
/turf/template_noop,
/area/template_noop)
"z" = (
/obj/effect/turf_decal/siding/white{
	dir = 1
	},
/obj/structure/railing{
	dir = 1
	},
/obj/machinery/door/firedoor/border_only{
	dir = 1
	},
/turf/open/floor/iron,
/area/station/commons/fitness)
"A" = (
/obj/effect/turf_decal/siding/white{
	dir = 8
	},
/obj/machinery/door/firedoor/border_only{
	dir = 8
	},
/turf/open/floor/iron,
/area/station/commons/fitness)
"D" = (
/obj/effect/landmark/start/hangover,
/obj/effect/turf_decal/siding/white{
	dir = 8
	},
/obj/structure/railing{
	dir = 8
	},
/obj/machinery/door/firedoor/border_only{
	dir = 8
	},
/turf/open/floor/iron,
/area/station/commons/fitness)
"E" = (
/turf/open/misc/asteroid/snow/icemoon,
/area/icemoon/surface/outdoors/nospawn)
"H" = (
/obj/effect/turf_decal/siding/white{
	dir = 8
	},
/obj/structure/railing{
	dir = 8
	},
/obj/machinery/door/firedoor/border_only{
	dir = 8
	},
/turf/open/floor/iron,
/area/station/commons/fitness)
"U" = (
/obj/effect/landmark/start/hangover,
/obj/effect/turf_decal/siding/white,
/obj/structure/railing,
/obj/machinery/door/firedoor/border_only,
/turf/open/floor/iron,
/area/station/commons/fitness)
"X" = (
/obj/effect/turf_decal/siding/white,
/obj/structure/railing,
/obj/machinery/door/firedoor/border_only,
/turf/open/floor/iron,
/area/station/commons/fitness)

(1,1,1) = {"
y
y
y
y
y
y
y
y
y
y
y
y
y
y
y
i
j
j
k
e
p
y
"}
(2,1,1) = {"
y
y
y
y
y
y
y
y
y
y
y
y
y
y
y
U
a
a
a
a
m
y
"}
(3,1,1) = {"
y
y
y
y
y
y
y
y
y
y
y
y
y
y
y
X
a
a
a
a
z
y
"}
(4,1,1) = {"
y
y
y
y
y
y
y
y
y
y
y
y
y
y
y
X
a
a
a
a
z
y
"}
(5,1,1) = {"
y
y
y
y
y
y
y
y
y
y
y
y
y
y
y
X
a
a
a
a
z
y
"}
(6,1,1) = {"
E
E
E
y
y
y
y
y
y
y
y
y
y
y
y
h
D
H
A
A
u
o
"}
(7,1,1) = {"
E
E
E
y
y
y
y
y
y
y
y
y
y
y
y
y
y
y
y
y
y
y
"}
(8,1,1) = {"
E
E
E
y
y
y
y
y
y
y
y
y
y
y
y
y
y
y
y
y
y
y
"}
(9,1,1) = {"
E
E
E
y
y
y
y
y
y
y
y
y
y
y
y
y
y
y
y
y
y
y
"}
(10,1,1) = {"
E
E
E
y
y
y
y
y
y
y
y
y
y
y
y
y
y
y
y
y
y
y
"}
(11,1,1) = {"
E
E
E
E
y
y
y
y
y
y
y
y
y
y
y
y
y
y
y
y
y
y
"}
(12,1,1) = {"
E
E
E
E
y
y
y
y
y
y
y
y
y
y
y
y
y
y
y
y
y
y
"}
(13,1,1) = {"
y
E
E
E
y
y
y
y
y
y
y
y
y
y
y
y
y
y
y
y
y
y
"}
