//MAP CONVERTED BY dmm2tgm.py THIS HEADER COMMENT PREVENTS RECONVERSION, DO NOT REMOVE
"a" = (
/obj/machinery/camera/directional/east{
	c_tag = "Arrivals Escape Pod 1"
	},
/obj/machinery/light/small/directional/south,
/obj/machinery/computer/shuttle/interlink{
	dir = 1
	},
/turf/open/floor/plating,
/area/station/hallway/secondary/entry)

(1,1,1) = {"
a
"}
