//MAP CONVERTED BY dmm2tgm.py THIS HEADER COMMENT PREVENTS RECONVERSION, DO NOT REMOVE
"a" = (
/turf/open/floor/iron/textured_large,
/area/misc/condo)
"b" = (
/obj/effect/turf_decal/siding/dark,
/obj/structure/fence,
/turf/open/misc/asteroid/moon,
/area/misc/condo)
"c" = (
/obj/effect/turf_decal/siding/thinplating_new/terracotta{
	dir = 1
	},
/obj/effect/turf_decal/trimline/white/line,
/turf/open/indestructible/boss/air,
/area/misc/condo)
"d" = (
/turf/open/indestructible/boss/air,
/area/misc/condo)
"e" = (
/turf/closed/indestructible/hoteldoor/fakedoor{
	dir = 4
	},
/area/misc/condo)
"f" = (
/turf/closed/indestructible/iron,
/area/misc/condo)
"g" = (
/obj/effect/turf_decal/siding/dark,
/obj/structure/fence,
/obj/effect/decal/cleanable/dirt/dust,
/turf/open/misc/asteroid/moon,
/area/misc/condo)
"h" = (
/obj/structure/sign/poster/official/report_crimes/directional/north,
/obj/effect/decal/cleanable/dirt,
/turf/open/floor/iron/textured_large,
/area/misc/condo)
"k" = (
/obj/effect/turf_decal/siding/dark,
/obj/structure/fence/door/opened,
/obj/effect/decal/cleanable/dirt,
/turf/open/misc/asteroid/moon,
/area/misc/condo)
"p" = (
/obj/structure/sign/poster/official/walk/directional/north,
/obj/effect/decal/cleanable/dirt,
/turf/open/floor/iron/textured_large,
/area/misc/condo)
"q" = (
/obj/effect/turf_decal/siding/thinplating_new/terracotta{
	dir = 1
	},
/turf/open/indestructible/boss/air,
/area/misc/condo)
"s" = (
/turf/closed/indestructible/hoteldoor/fakedoor,
/area/misc/condo)
"v" = (
/obj/structure/fence{
	dir = 4
	},
/obj/effect/decal/cleanable/dirt,
/turf/open/misc/asteroid/moon,
/area/misc/condo)
"z" = (
/obj/effect/decal/cleanable/dirt,
/turf/open/indestructible/boss/air,
/area/misc/condo)
"A" = (
/obj/effect/light_emitter/fake_outdoors,
/turf/open/indestructible/boss/air,
/area/misc/condo)
"I" = (
/turf/open/misc/asteroid/moon,
/area/misc/condo)
"J" = (
/obj/effect/planetary_turf_atmos_helper,
/turf/closed/indestructible/iron,
/area/misc/condo)
"M" = (
/obj/effect/decal/cleanable/dirt/dust,
/turf/open/misc/asteroid/moon,
/area/misc/condo)
"P" = (
/obj/effect/turf_decal/siding/thinplating_new/terracotta{
	dir = 1
	},
/obj/effect/decal/cleanable/dirt,
/turf/open/indestructible/boss/air,
/area/misc/condo)
"R" = (
/obj/structure/closet/crate/trashcart,
/obj/effect/decal/cleanable/dirt/dust,
/turf/open/misc/asteroid/moon,
/area/misc/condo)
"T" = (
/turf/template_noop,
/area/template_noop)
"V" = (
/obj/structure/fence/end{
	dir = 4
	},
/turf/open/misc/asteroid/moon,
/area/misc/condo)
"X" = (
/obj/structure/closet/crate/preopen,
/obj/effect/decal/cleanable/dirt,
/turf/open/misc/asteroid/moon,
/area/misc/condo)
"Y" = (
/obj/effect/decal/cleanable/dirt,
/turf/open/misc/asteroid/moon,
/area/misc/condo)
"Z" = (
/obj/effect/turf_decal/trimline/white/line,
/turf/open/indestructible/boss/air,
/area/misc/condo)

(1,1,1) = {"
T
T
T
T
T
T
T
T
J
a
c
Z
"}
(2,1,1) = {"
f
f
f
f
f
f
e
f
f
h
c
Z
"}
(3,1,1) = {"
s
I
M
I
M
M
I
Y
b
a
P
d
"}
(4,1,1) = {"
f
v
V
Y
I
I
M
M
k
a
q
d
"}
(5,1,1) = {"
f
X
I
M
M
Y
I
R
g
a
q
z
"}
(6,1,1) = {"
f
f
f
f
f
e
f
f
f
a
q
d
"}
(7,1,1) = {"
T
T
T
T
T
T
T
T
f
p
q
A
"}
