//MAP CONVERTED BY dmm2tgm.py THIS HEADER COMMENT PREVENTS RECONVERSION, DO NOT REMOVE
"au" = (
/obj/structure/bed/double{
	dir = 8
	},
/obj/effect/spawner/random/bedsheet/double,
/turf/open/floor/wood/large,
/area/misc/condo)
"ax" = (
/obj/effect/turf_decal/weather/sand{
	dir = 5
	},
/turf/open/floor/iron/sepia,
/area/misc/condo)
"az" = (
/turf/closed/indestructible/rock,
/area/misc/condo)
"aG" = (
/turf/open/misc/beach/coast/corner{
	dir = 4
	},
/area/misc/condo)
"bg" = (
/turf/open/misc/beach/sand,
/area/misc/condo)
"bD" = (
/turf/open/misc/beach/coast{
	dir = 5
	},
/area/misc/condo)
"bK" = (
/obj/structure/chair/comfy/teal{
	dir = 8
	},
/obj/machinery/light_switch/directional/east,
/turf/open/floor/wood/large,
/area/misc/condo)
"cH" = (
/turf/closed/indestructible/sandstone,
/area/misc/condo)
"dk" = (
/obj/machinery/shower/directional/west,
/obj/effect/spawner/liquids_spawner,
/turf/open/floor/iron/pool,
/area/misc/condo)
"dp" = (
/obj/structure/chair{
	dir = 4
	},
/turf/open/floor/wood/tile,
/area/misc/condo)
"eE" = (
/obj/effect/turf_decal/siding/wood{
	dir = 8
	},
/obj/effect/turf_decal/siding/wood{
	dir = 4
	},
/obj/machinery/door/airlock/grunge{
	dir = 4;
	name = "Kitchenette"
	},
/turf/open/floor/wood/large,
/area/misc/condo)
"eY" = (
/turf/open/water/beach,
/area/misc/condo)
"fx" = (
/turf/closed/indestructible/wood,
/area/misc/condo)
"gP" = (
/turf/open/misc/beach/coast{
	dir = 9
	},
/area/misc/condo)
"gU" = (
/obj/machinery/jukebox/no_access,
/turf/open/misc/beach/sand,
/area/misc/condo)
"hp" = (
/turf/open/floor/carpet/purple,
/area/misc/condo)
"ig" = (
/obj/effect/turf_decal/trimline/dark/filled/line{
	dir = 10
	},
/obj/effect/turf_decal/trimline/dark/filled/mid_joiner,
/obj/effect/turf_decal/trimline/dark/filled/mid_joiner{
	pixel_x = 16
	},
/obj/effect/turf_decal/trimline/dark/filled/mid_joiner{
	dir = 8
	},
/turf/open/floor/wood,
/area/misc/condo)
"kH" = (
/obj/effect/turf_decal/siding/wood{
	dir = 1
	},
/obj/effect/turf_decal/siding/wood,
/obj/machinery/door/airlock/grunge{
	name = "Master Bedroom"
	},
/turf/open/floor/wood/large,
/area/misc/condo)
"kY" = (
/obj/structure/window_frame/sandstone,
/obj/structure/window/reinforced/fulltile/indestructible,
/obj/structure/curtain/cloth/fancy,
/turf/open/floor/plating,
/area/misc/condo)
"lA" = (
/obj/machinery/light/directional/south,
/turf/open/floor/wood/large,
/area/misc/condo)
"mE" = (
/obj/structure/sign/painting/interlink/directional/north,
/turf/open/floor/wood/tile,
/area/misc/condo)
"mY" = (
/obj/structure/table/wood,
/turf/open/floor/wood/tile,
/area/misc/condo)
"nt" = (
/obj/effect/turf_decal/siding/white{
	dir = 8
	},
/turf/open/floor/iron/kitchen,
/area/misc/condo)
"nR" = (
/obj/machinery/light/directional/north,
/turf/open/floor/wood/tile,
/area/misc/condo)
"oU" = (
/turf/closed/indestructible/fakeglass,
/area/misc/condo)
"oX" = (
/obj/structure/table/wood,
/obj/item/reagent_containers/cup/rag{
	pixel_y = 8
	},
/turf/open/floor/wood/tile,
/area/misc/condo)
"pU" = (
/obj/effect/turf_decal/siding/wood{
	dir = 8
	},
/obj/effect/turf_decal/siding/wood{
	dir = 4
	},
/obj/machinery/door/airlock/silver{
	dir = 4;
	name = "Bathroom"
	},
/turf/open/floor/wood/large,
/area/misc/condo)
"qD" = (
/obj/effect/turf_decal/siding/white,
/obj/machinery/door/window/right/directional/south,
/obj/effect/turf_decal/tile/purple{
	dir = 1
	},
/obj/effect/turf_decal/trimline/purple/line,
/turf/open/indestructible/hoteltile,
/area/misc/condo)
"qE" = (
/obj/machinery/light_switch/directional/west,
/turf/open/floor/wood/tile,
/area/misc/condo)
"sy" = (
/obj/effect/decal/cleanable/dirt/dust,
/obj/structure/grille/broken,
/turf/open/floor/plating,
/area/misc/condo)
"tb" = (
/obj/structure/closet/secure_closet/personal/cabinet,
/obj/item/hairbrush,
/turf/open/floor/wood/large,
/area/misc/condo)
"ue" = (
/turf/open/floor/iron/sepia,
/area/misc/condo)
"ve" = (
/obj/effect/turf_decal/siding/wood{
	dir = 9
	},
/obj/machinery/light_switch/directional/east,
/turf/open/floor/wood/parquet,
/area/misc/condo)
"vH" = (
/obj/item/kirbyplants/random,
/obj/structure/sign/poster/official/corporate_perks_vacation/directional/north,
/turf/open/floor/wood/tile,
/area/misc/condo)
"wd" = (
/turf/closed/indestructible/hoteldoor/fakedoor,
/area/misc/condo)
"wo" = (
/obj/structure/bed/dogbed,
/turf/open/floor/wood/large,
/area/misc/condo)
"wt" = (
/turf/open/misc/beach/coast/corner{
	dir = 8
	},
/area/misc/condo)
"xh" = (
/obj/structure/toilet{
	dir = 4
	},
/obj/effect/turf_decal/tile/purple,
/obj/effect/turf_decal/trimline/purple/line{
	dir = 1
	},
/obj/machinery/light/directional/north,
/turf/open/indestructible/hoteltile,
/area/misc/condo)
"xo" = (
/obj/structure/chair{
	dir = 8
	},
/turf/open/floor/wood/tile,
/area/misc/condo)
"xB" = (
/obj/effect/turf_decal/siding/white,
/obj/machinery/door/window/left/directional/south,
/obj/effect/turf_decal/trimline/purple/line,
/turf/open/indestructible/hoteltile,
/area/misc/condo)
"xD" = (
/obj/effect/turf_decal/siding/white{
	dir = 9
	},
/turf/open/floor/iron/kitchen,
/area/misc/condo)
"yh" = (
/turf/open/floor/wood/tile,
/area/misc/condo)
"zx" = (
/obj/effect/turf_decal/weather/sand{
	dir = 1
	},
/turf/open/floor/iron/sepia,
/area/misc/condo)
"Aa" = (
/obj/structure/closet/crate/bin,
/turf/open/floor/wood/tile,
/area/misc/condo)
"Ex" = (
/turf/open/misc/beach/coast{
	dir = 1
	},
/area/misc/condo)
"FI" = (
/obj/effect/turf_decal/siding/wood{
	dir = 4
	},
/obj/effect/turf_decal/siding/wood{
	dir = 8
	},
/obj/machinery/door/morgue{
	dir = 4;
	name = "Sunroom"
	},
/turf/open/floor/wood/large,
/area/misc/condo)
"FJ" = (
/obj/effect/decal/cleanable/dirt/dust,
/obj/structure/grille,
/turf/open/floor/plating,
/area/misc/condo)
"GJ" = (
/obj/structure/chair{
	dir = 4
	},
/obj/machinery/light/directional/west,
/turf/open/floor/wood/tile,
/area/misc/condo)
"GY" = (
/obj/structure/table/reinforced,
/obj/machinery/microwave{
	pixel_y = 8
	},
/turf/open/floor/iron/kitchen,
/area/misc/condo)
"Hy" = (
/obj/effect/turf_decal/siding/wood{
	dir = 1
	},
/obj/effect/turf_decal/siding/wood,
/obj/machinery/door/airlock/sandstone{
	name = "Sunroom"
	},
/turf/open/floor/wood/large,
/area/misc/condo)
"Kb" = (
/obj/structure/table/wood,
/obj/item/flashlight/lamp/green{
	pixel_y = 6;
	pixel_x = -7
	},
/turf/open/floor/wood/large,
/area/misc/condo)
"Kw" = (
/obj/structure/tall_stairs/small/directional/south,
/turf/open/misc/beach/sand,
/area/misc/condo)
"KH" = (
/obj/effect/turf_decal/siding/wood/end{
	dir = 8
	},
/obj/structure/closet/secure_closet/personal/cabinet,
/turf/open/floor/wood,
/area/misc/condo)
"Lx" = (
/turf/open/floor/wood/large,
/area/misc/condo)
"Pf" = (
/turf/template_noop,
/area/template_noop)
"Py" = (
/obj/effect/turf_decal/siding/white{
	dir = 1
	},
/obj/structure/table/reinforced,
/turf/open/floor/iron/kitchen,
/area/misc/condo)
"Rl" = (
/obj/effect/turf_decal/siding/wood/end{
	dir = 4
	},
/obj/machinery/light/floor,
/turf/open/floor/wood,
/area/misc/condo)
"Ui" = (
/obj/effect/decal/cleanable/dirt/dust,
/obj/structure/bed/pillow_large,
/turf/open/floor/plating,
/area/misc/condo)
"UB" = (
/obj/effect/turf_decal/trimline/dark/filled/line,
/obj/effect/turf_decal/trimline/dark/filled/mid_joiner,
/obj/effect/turf_decal/trimline/dark/filled/mid_joiner{
	pixel_x = 16
	},
/turf/open/floor/wood,
/area/misc/condo)
"UE" = (
/obj/structure/dresser,
/turf/open/floor/wood/large,
/area/misc/condo)
"VS" = (
/turf/closed/wall/mineral/sandstone,
/area/misc/condo)
"WM" = (
/obj/effect/spawner/liquids_spawner,
/turf/open/floor/iron/pool,
/area/misc/condo)
"Ym" = (
/obj/item/kirbyplants/random,
/obj/effect/turf_decal/siding/wood{
	dir = 5
	},
/turf/open/floor/wood/parquet,
/area/misc/condo)
"Yq" = (
/obj/structure/sink/directional/south,
/obj/structure/mirror/directional/north,
/obj/effect/turf_decal/trimline/purple/line{
	dir = 1
	},
/turf/open/indestructible/hoteltile,
/area/misc/condo)
"YR" = (
/obj/structure/closet/secure_closet/freezer/fridge/all_access,
/obj/effect/spawner/random/food_or_drink/three_course_meal,
/turf/open/floor/wood/tile,
/area/misc/condo)
"YS" = (
/obj/structure/fluff/beach_umbrella/science,
/turf/open/misc/beach/coast{
	dir = 1
	},
/area/misc/condo)

(1,1,1) = {"
az
az
az
az
az
az
az
az
az
Pf
cH
cH
cH
cH
cH
"}
(2,1,1) = {"
az
az
az
az
az
Ex
bg
bg
cH
cH
cH
Ui
sy
FJ
cH
"}
(3,1,1) = {"
az
az
eY
eY
eY
Ex
bg
bg
cH
KH
cH
VS
VS
VS
cH
"}
(4,1,1) = {"
az
eY
eY
eY
gP
aG
bg
Kw
Hy
Rl
fx
xh
xB
WM
cH
"}
(5,1,1) = {"
az
eY
eY
eY
Ex
bg
bg
cH
cH
FI
fx
Yq
qD
dk
cH
"}
(6,1,1) = {"
az
az
eY
eY
Ex
bg
cH
cH
UE
Lx
fx
pU
fx
cH
cH
"}
(7,1,1) = {"
az
az
eY
gP
aG
bg
kY
wo
Kb
lA
fx
mE
Ym
oU
ig
"}
(8,1,1) = {"
az
az
eY
YS
hp
hp
kY
Lx
Lx
Lx
kH
yh
yh
wd
UB
"}
(9,1,1) = {"
az
eY
eY
bD
wt
bg
kY
au
bK
tb
fx
nR
ve
oU
UB
"}
(10,1,1) = {"
az
eY
eY
eY
Ex
bg
cH
cH
cH
fx
fx
eE
fx
cH
cH
"}
(11,1,1) = {"
az
eY
eY
eY
Ex
bg
zx
ue
kY
dp
GJ
yh
qE
Aa
cH
"}
(12,1,1) = {"
az
az
eY
eY
bD
wt
ax
ue
kY
mY
oX
yh
yh
yh
cH
"}
(13,1,1) = {"
az
az
eY
eY
eY
Ex
bg
ax
kY
xo
xo
yh
xD
nt
cH
"}
(14,1,1) = {"
az
az
az
eY
eY
Ex
bg
bg
cH
cH
vH
YR
Py
GY
cH
"}
(15,1,1) = {"
az
az
az
az
eY
bD
wt
bg
gU
cH
cH
cH
cH
cH
cH
"}
(16,1,1) = {"
az
az
az
az
az
az
az
az
az
az
Pf
Pf
Pf
Pf
Pf
"}
