//MAP CONVERTED BY dmm2tgm.py THIS HEADER COMMENT PREVENTS RECONVERSION, DO NOT REMOVE
"af" = (
/obj/effect/turf_decal/siding/wood,
/turf/open/floor/wood/large,
/area/misc/condo)
"ag" = (
/obj/effect/turf_decal/siding/wood{
	dir = 4
	},
/obj/structure/chair/pew/right{
	dir = 1
	},
/obj/structure/disposalpipe/segment{
	dir = 4
	},
/turf/open/floor/wood/parquet,
/area/misc/condo)
"aH" = (
/obj/structure/chair/comfy/teal,
/turf/open/floor/carpet/cyan,
/area/misc/condo)
"aI" = (
/obj/effect/turf_decal/plaque{
	icon_state = "L9"
	},
/obj/effect/turf_decal/trimline/dark/filled/line,
/obj/effect/turf_decal/trimline/dark/filled/mid_joiner,
/obj/effect/turf_decal/trimline/dark/filled/mid_joiner{
	pixel_x = 16
	},
/turf/open/floor/iron,
/area/misc/condo)
"aM" = (
/obj/effect/turf_decal/siding/wood/corner{
	dir = 8
	},
/turf/open/floor/wood/parquet,
/area/misc/condo)
"bs" = (
/obj/structure/disposalpipe/segment{
	dir = 9
	},
/turf/open/floor/carpet/black,
/area/misc/condo)
"bK" = (
/obj/effect/turf_decal/siding/wood{
	dir = 8
	},
/obj/structure/chair/pew/left{
	dir = 1
	},
/turf/open/floor/wood/parquet,
/area/misc/condo)
"ce" = (
/obj/effect/planetary_turf_atmos_helper,
/turf/closed/indestructible/normal_wall,
/area/misc/condo)
"cf" = (
/obj/effect/turf_decal/siding/wood/corner,
/turf/open/floor/wood/parquet,
/area/misc/condo)
"cH" = (
/obj/effect/turf_decal/siding/wood,
/turf/open/floor/wood/tile,
/area/misc/condo)
"df" = (
/obj/effect/turf_decal/siding/wood{
	dir = 4
	},
/obj/effect/turf_decal/siding/wood{
	dir = 8
	},
/obj/structure/fluff/fake_firedoor{
	dir = 8
	},
/turf/open/floor/wood/large,
/area/misc/condo)
"dw" = (
/obj/structure/disposalpipe/segment{
	dir = 10
	},
/turf/open/floor/catwalk_floor,
/area/misc/condo)
"dT" = (
/turf/closed/indestructible/hoteldoor/fakedoor/public,
/area/misc/condo)
"eI" = (
/obj/structure/table/wood/fancy/black,
/obj/effect/turf_decal/siding/wood{
	dir = 8
	},
/obj/machinery/light/directional/east,
/obj/item/food/grown/poppy{
	pixel_y = 8
	},
/obj/item/food/grown/poppy{
	pixel_y = 8
	},
/turf/open/floor/wood/large,
/area/misc/condo)
"eJ" = (
/obj/effect/turf_decal/siding/wood{
	dir = 10
	},
/obj/structure/chair/pew/left{
	dir = 1
	},
/turf/open/floor/wood/parquet,
/area/misc/condo)
"fb" = (
/turf/open/floor/pod,
/area/misc/condo)
"fe" = (
/obj/effect/turf_decal/siding/wood,
/obj/structure/closet,
/turf/open/floor/wood/large,
/area/misc/condo)
"fx" = (
/obj/effect/turf_decal/siding/wood{
	dir = 4
	},
/obj/structure/fluff/fake_vent,
/turf/open/floor/wood/parquet,
/area/misc/condo)
"fF" = (
/obj/structure/table/wood,
/turf/open/floor/carpet/black,
/area/misc/condo)
"fK" = (
/obj/effect/turf_decal/tile/dark{
	dir = 1
	},
/obj/effect/turf_decal/trimline/dark/line{
	dir = 4
	},
/obj/effect/turf_decal/siding/wood,
/turf/open/floor/wood/tile,
/area/misc/condo)
"fT" = (
/obj/structure/fluff/fake_vent,
/turf/open/floor/carpet/black,
/area/misc/condo)
"gi" = (
/obj/structure/fluff/fake_scrubber,
/turf/open/floor/wood/tile,
/area/misc/condo)
"gS" = (
/turf/closed/indestructible/rock,
/area/misc/condo)
"gT" = (
/obj/structure/disposalpipe/segment{
	dir = 6
	},
/turf/open/floor/wood/tile,
/area/misc/condo)
"gW" = (
/turf/open/floor/wood/tile,
/area/misc/condo)
"hN" = (
/obj/machinery/light/directional/south,
/turf/open/floor/carpet/black,
/area/misc/condo)
"hQ" = (
/turf/closed/indestructible/fakeglass,
/area/misc/condo)
"ia" = (
/obj/effect/turf_decal/siding/wood{
	dir = 8
	},
/turf/open/floor/wood/parquet,
/area/misc/condo)
"ii" = (
/obj/structure/table/wood,
/obj/item/paper_bin{
	pixel_x = -2;
	pixel_y = 8
	},
/obj/item/pen,
/turf/open/floor/carpet/cyan,
/area/misc/condo)
"iY" = (
/obj/structure/table/wood,
/obj/item/flashlight/lamp,
/turf/open/floor/carpet/cyan,
/area/misc/condo)
"jv" = (
/obj/effect/turf_decal/siding/wood,
/obj/structure/rack,
/turf/open/floor/wood/large,
/area/misc/condo)
"kP" = (
/obj/structure/flora/ocean/coral,
/obj/effect/spawner/liquids_spawner/fulltile,
/turf/open/misc/asteroid,
/area/misc/condo)
"li" = (
/obj/structure/fluff/fake_vent,
/turf/open/floor/carpet/cyan,
/area/misc/condo)
"lk" = (
/obj/effect/turf_decal/tile/neutral{
	dir = 8
	},
/obj/effect/turf_decal/trimline/dark/filled/line,
/obj/effect/turf_decal/trimline/dark/filled/mid_joiner,
/obj/effect/turf_decal/trimline/dark/filled/mid_joiner{
	pixel_x = 16
	},
/turf/open/floor/iron,
/area/misc/condo)
"lT" = (
/obj/structure/flora/rock/style_random,
/obj/effect/spawner/liquids_spawner/fulltile,
/turf/open/misc/asteroid,
/area/misc/condo)
"me" = (
/obj/structure/reagent_dispensers/water_cooler,
/turf/open/floor/wood/tile,
/area/misc/condo)
"mK" = (
/obj/structure/fluff/fake_scrubber,
/turf/open/floor/wood/parquet,
/area/misc/condo)
"no" = (
/obj/structure/disposalpipe/segment,
/turf/open/floor/carpet/black,
/area/misc/condo)
"ns" = (
/obj/effect/turf_decal/plaque{
	icon_state = "L11"
	},
/obj/effect/turf_decal/trimline/dark/filled/line,
/obj/effect/turf_decal/trimline/dark/filled/mid_joiner,
/obj/effect/turf_decal/trimline/dark/filled/mid_joiner{
	pixel_x = 16
	},
/turf/open/floor/iron,
/area/misc/condo)
"nQ" = (
/obj/effect/turf_decal/plaque{
	icon_state = "L5"
	},
/obj/structure/sign/poster/official/random/directional/north,
/obj/effect/turf_decal/trimline/dark/filled/line,
/obj/effect/turf_decal/trimline/dark/filled/mid_joiner,
/obj/effect/turf_decal/trimline/dark/filled/mid_joiner{
	pixel_x = 16
	},
/turf/open/floor/iron,
/area/misc/condo)
"oF" = (
/obj/structure/flora/rock/pile/style_random,
/obj/effect/spawner/liquids_spawner/fulltile,
/turf/open/misc/asteroid,
/area/misc/condo)
"py" = (
/obj/item/kirbyplants/random,
/turf/open/floor/wood/tile,
/area/misc/condo)
"pO" = (
/obj/structure/closet/crate,
/obj/effect/turf_decal/trimline/green/warning{
	dir = 1
	},
/turf/open/floor/pod/dark,
/area/misc/condo)
"qj" = (
/obj/effect/turf_decal/siding/wood{
	dir = 8
	},
/obj/structure/chair/pew/left{
	dir = 1
	},
/obj/structure/disposalpipe/segment{
	dir = 4
	},
/turf/open/floor/wood/parquet,
/area/misc/condo)
"ql" = (
/obj/effect/spawner/liquids_spawner/fulltile,
/turf/open/misc/asteroid,
/area/misc/condo)
"qB" = (
/obj/effect/spawner/structure/window/reinforced/tinted,
/turf/open/floor/plating,
/area/misc/condo)
"rJ" = (
/obj/structure/closet,
/turf/open/floor/pod,
/area/misc/condo)
"rU" = (
/obj/structure/chair/stool/directional/east,
/obj/machinery/light/small/directional/south,
/turf/open/floor/iron/dark/small,
/area/misc/condo)
"sv" = (
/obj/effect/turf_decal/plaque{
	icon_state = "L13"
	},
/obj/machinery/light/built/directional/north,
/obj/effect/turf_decal/trimline/dark/filled/line,
/obj/effect/turf_decal/trimline/dark/filled/mid_joiner,
/obj/effect/turf_decal/trimline/dark/filled/mid_joiner{
	pixel_x = 16
	},
/turf/open/floor/iron,
/area/misc/condo)
"sH" = (
/turf/closed/indestructible/fakedoor/maintenance{
	name = "Fore Maintenance"
	},
/area/misc/condo)
"uv" = (
/obj/structure/disposalpipe/segment{
	dir = 4
	},
/turf/open/floor/carpet/black,
/area/misc/condo)
"uz" = (
/obj/effect/turf_decal/plaque{
	icon_state = "L1"
	},
/obj/effect/turf_decal/trimline/dark/filled/line{
	dir = 10
	},
/obj/effect/turf_decal/trimline/dark/filled/mid_joiner{
	dir = 8
	},
/obj/effect/turf_decal/trimline/dark/filled/mid_joiner,
/obj/effect/turf_decal/trimline/dark/filled/mid_joiner{
	pixel_x = 16
	},
/turf/open/floor/iron,
/area/misc/condo)
"uP" = (
/obj/effect/turf_decal/trimline/green/warning{
	dir = 1
	},
/obj/structure/disposalpipe/broken{
	dir = 1
	},
/turf/open/floor/pod/dark,
/area/misc/condo)
"vg" = (
/obj/structure/chair/stool/directional/east,
/obj/machinery/light/small/directional/north,
/turf/open/floor/iron/dark/small,
/area/misc/condo)
"vp" = (
/obj/effect/spawner/liquids_spawner/fulltile,
/obj/structure/flora/ocean/longseaweed,
/turf/open/misc/asteroid,
/area/misc/condo)
"wV" = (
/obj/structure/sign/departments/holy/directional/north,
/obj/effect/turf_decal/tile/neutral{
	dir = 8
	},
/obj/effect/turf_decal/trimline/dark/filled/line,
/obj/effect/turf_decal/trimline/dark/filled/mid_joiner,
/obj/effect/turf_decal/trimline/dark/filled/mid_joiner{
	pixel_x = 16
	},
/turf/open/floor/iron,
/area/misc/condo)
"yb" = (
/turf/open/floor/carpet/black,
/area/misc/condo)
"ys" = (
/obj/structure/disposalpipe/segment{
	dir = 4
	},
/turf/open/floor/catwalk_floor,
/area/misc/condo)
"zF" = (
/obj/structure/flora/ocean/longseaweed,
/obj/effect/spawner/liquids_spawner/fulltile,
/turf/open/misc/asteroid,
/area/misc/condo)
"zP" = (
/turf/closed/indestructible/normal_wall,
/area/misc/condo)
"AE" = (
/obj/structure/fluff/fake_firedoor,
/obj/structure/railing{
	dir = 1
	},
/turf/open/floor/catwalk_floor,
/area/misc/condo)
"AL" = (
/turf/open/floor/carpet/cyan,
/area/misc/condo)
"AP" = (
/obj/structure/curtain/cloth/fancy,
/turf/closed/indestructible/fakeglass,
/area/misc/condo)
"Bw" = (
/obj/structure/flora/ocean/glowweed,
/obj/effect/spawner/liquids_spawner/fulltile,
/turf/open/misc/asteroid,
/area/misc/condo)
"CK" = (
/obj/structure/fluff/divine/convertaltar,
/turf/open/floor/carpet/black,
/area/misc/condo)
"Dx" = (
/obj/effect/turf_decal/trimline/green/warning,
/turf/open/floor/pod/dark,
/area/misc/condo)
"EE" = (
/turf/open/floor/wood/parquet,
/area/misc/condo)
"FX" = (
/obj/structure/table/wood,
/turf/open/floor/carpet/cyan,
/area/misc/condo)
"Gh" = (
/obj/effect/turf_decal/plaque{
	icon_state = "L7"
	},
/obj/effect/turf_decal/trimline/dark/filled/line,
/obj/effect/turf_decal/trimline/dark/filled/mid_joiner,
/obj/effect/turf_decal/trimline/dark/filled/mid_joiner{
	pixel_x = 16
	},
/turf/open/floor/iron,
/area/misc/condo)
"Gm" = (
/obj/machinery/computer/old{
	dir = 8
	},
/obj/machinery/light/directional/east,
/turf/open/floor/carpet/cyan,
/area/misc/condo)
"GR" = (
/obj/structure/table/wood/fancy/black,
/obj/effect/turf_decal/siding/wood{
	dir = 8
	},
/obj/item/food/grown/harebell{
	pixel_y = 8
	},
/obj/item/food/grown/harebell{
	pixel_y = 8
	},
/turf/open/floor/wood/large,
/area/misc/condo)
"Ho" = (
/obj/effect/turf_decal/trimline/dark/filled/line,
/obj/effect/turf_decal/trimline/dark/filled/mid_joiner,
/obj/effect/turf_decal/trimline/dark/filled/mid_joiner{
	pixel_x = 16
	},
/turf/open/floor/iron,
/area/misc/condo)
"Hp" = (
/obj/structure/closet/secure_closet/personal/cabinet,
/turf/open/floor/wood/parquet,
/area/misc/condo)
"It" = (
/obj/effect/turf_decal/siding/wood,
/obj/structure/table/wood/fancy/black,
/obj/item/storage/fancy/candle_box{
	pixel_y = 9
	},
/obj/structure/extinguisher_cabinet/directional/north,
/turf/open/floor/wood/large,
/area/misc/condo)
"Iu" = (
/obj/structure/disposalpipe/segment{
	dir = 4
	},
/turf/open/floor/wood/large,
/area/misc/condo)
"IW" = (
/turf/closed/indestructible/fakedoor/maintenance{
	dir = 4;
	name = "Fore Maintenance"
	},
/area/misc/condo)
"JH" = (
/obj/structure/rack,
/obj/effect/turf_decal/trimline/green/warning,
/turf/open/floor/pod/dark,
/area/misc/condo)
"Kv" = (
/obj/structure/table/wood,
/obj/item/flashlight/lantern{
	pixel_y = 7
	},
/turf/open/floor/carpet/black,
/area/misc/condo)
"KA" = (
/obj/effect/turf_decal/siding/wood{
	dir = 4
	},
/obj/effect/turf_decal/siding/wood{
	dir = 8
	},
/obj/machinery/door/airlock/grunge{
	name = "Chapel Office";
	dir = 4
	},
/turf/open/floor/wood/large,
/area/misc/condo)
"Lr" = (
/obj/structure/bookcase/random/religion,
/obj/effect/turf_decal/siding/wood{
	dir = 8
	},
/turf/open/floor/wood/large,
/area/misc/condo)
"LB" = (
/obj/effect/turf_decal/plaque{
	icon_state = "L3"
	},
/obj/effect/turf_decal/trimline/dark/filled/line,
/obj/effect/turf_decal/trimline/dark/filled/mid_joiner,
/obj/effect/turf_decal/trimline/dark/filled/mid_joiner{
	pixel_x = 16
	},
/turf/open/floor/iron,
/area/misc/condo)
"MH" = (
/obj/effect/turf_decal/siding/wood{
	dir = 1
	},
/turf/open/floor/wood/large,
/area/misc/condo)
"MP" = (
/obj/structure/fluff/fake_vent,
/turf/open/floor/wood/tile,
/area/misc/condo)
"MY" = (
/obj/effect/turf_decal/siding/wood{
	dir = 4
	},
/turf/open/floor/wood/parquet,
/area/misc/condo)
"NJ" = (
/obj/effect/turf_decal/tile/dark{
	dir = 4
	},
/obj/effect/turf_decal/trimline/dark/line{
	dir = 8
	},
/obj/effect/turf_decal/siding/wood,
/obj/machinery/light_switch/directional/north,
/turf/open/floor/wood/tile,
/area/misc/condo)
"NV" = (
/obj/effect/turf_decal/stripes/line{
	dir = 4
	},
/obj/effect/turf_decal/siding/wood{
	dir = 8
	},
/obj/machinery/door/airlock/grunge{
	dir = 4;
	name = "Fore Maintenance"
	},
/obj/structure/disposalpipe/segment{
	dir = 4
	},
/turf/open/floor/plating,
/area/misc/condo)
"Ol" = (
/obj/structure/fluff/fake_scrubber,
/turf/open/floor/carpet/cyan,
/area/misc/condo)
"Pe" = (
/obj/structure/disposalpipe/segment{
	dir = 6
	},
/turf/open/floor/carpet/black,
/area/misc/condo)
"Po" = (
/turf/open/floor/wood/large,
/area/misc/condo)
"Qs" = (
/obj/machinery/light/directional/west,
/turf/open/floor/carpet/black,
/area/misc/condo)
"Qz" = (
/obj/structure/fluff/fake_firedoor{
	dir = 8
	},
/obj/effect/turf_decal/trimline/dark/filled/line,
/obj/effect/turf_decal/trimline/dark/filled/mid_joiner,
/obj/effect/turf_decal/trimline/dark/filled/mid_joiner{
	pixel_x = 16
	},
/turf/open/floor/iron/textured_large,
/area/misc/condo)
"QP" = (
/obj/structure/flora/ocean/seaweed,
/obj/effect/spawner/liquids_spawner/fulltile,
/turf/open/misc/asteroid,
/area/misc/condo)
"RN" = (
/turf/closed/indestructible/fakedoor{
	dir = 8;
	name = "Fore Maintenance"
	},
/area/misc/condo)
"Sd" = (
/obj/effect/turf_decal/siding/wood{
	dir = 6
	},
/obj/structure/chair/pew/right{
	dir = 1
	},
/turf/open/floor/wood/parquet,
/area/misc/condo)
"Sr" = (
/obj/effect/turf_decal/siding/wood,
/obj/machinery/light/small/directional/north,
/obj/structure/bookcase/random/religion,
/turf/open/floor/wood/large,
/area/misc/condo)
"Tx" = (
/obj/effect/turf_decal/siding/wood,
/turf/open/floor/wood/parquet,
/area/misc/condo)
"TL" = (
/obj/effect/turf_decal/siding/wood,
/obj/effect/turf_decal/siding/wood{
	dir = 1
	},
/obj/machinery/door/airlock/grunge{
	name = "Chapel Office"
	},
/turf/open/floor/wood/large,
/area/misc/condo)
"TT" = (
/obj/effect/turf_decal/siding/wood{
	dir = 4
	},
/obj/effect/turf_decal/siding/wood{
	dir = 8
	},
/obj/machinery/door/morgue{
	name = "Confession Booth";
	dir = 4
	},
/turf/open/floor/wood/large,
/area/misc/condo)
"UM" = (
/obj/effect/turf_decal/siding/wood{
	dir = 4
	},
/obj/effect/turf_decal/siding/wood{
	dir = 8
	},
/obj/structure/fluff/fake_firedoor{
	dir = 8
	},
/obj/structure/disposalpipe/segment{
	dir = 4
	},
/turf/open/floor/wood/large,
/area/misc/condo)
"Vx" = (
/obj/effect/turf_decal/siding/wood{
	dir = 8
	},
/obj/structure/fluff/fake_scrubber,
/turf/open/floor/wood/parquet,
/area/misc/condo)
"Vz" = (
/obj/effect/turf_decal/siding/wood{
	dir = 4
	},
/obj/structure/chair/pew/right{
	dir = 1
	},
/turf/open/floor/wood/parquet,
/area/misc/condo)
"VD" = (
/obj/structure/dresser,
/obj/machinery/light/directional/north,
/turf/open/floor/wood/parquet,
/area/misc/condo)
"Xj" = (
/obj/structure/bed/double{
	dir = 1
	},
/obj/item/bedsheet/chaplain/double{
	dir = 1
	},
/turf/open/floor/carpet/black,
/area/misc/condo)
"Xq" = (
/obj/effect/turf_decal/siding/wood{
	dir = 8
	},
/obj/structure/disposalpipe/segment{
	dir = 4
	},
/turf/open/floor/wood/large,
/area/misc/condo)
"Yf" = (
/obj/machinery/disposal/bin,
/obj/structure/disposalpipe/trunk{
	dir = 1
	},
/turf/open/floor/wood/tile,
/area/misc/condo)
"ZA" = (
/turf/cordon,
/area/misc/condo)

(1,1,1) = {"
ZA
ZA
ZA
ZA
ZA
ZA
ZA
ZA
ZA
ZA
ZA
ZA
zP
zP
zP
zP
zP
uz
"}
(2,1,1) = {"
ZA
ZA
ZA
ZA
ZA
ZA
ZA
ZA
ZA
ZA
ZA
ZA
zP
vg
qB
rU
zP
LB
"}
(3,1,1) = {"
ZA
ZA
ZA
ZA
ZA
ZA
ZA
ZA
ZA
ZA
ZA
zP
zP
TT
zP
TT
zP
nQ
"}
(4,1,1) = {"
ZA
ZA
zP
zP
zP
zP
ZA
ZA
ZA
ZA
ZA
zP
It
MP
gW
gi
zP
Gh
"}
(5,1,1) = {"
ZA
zP
zP
Xj
fF
zP
gS
ZA
ZA
ZA
ZA
zP
Sr
gW
gT
Yf
zP
aI
"}
(6,1,1) = {"
ZA
zP
VD
fT
yb
AE
gS
ZA
ZA
zP
zP
ce
zP
df
UM
zP
zP
ns
"}
(7,1,1) = {"
ZA
zP
Hp
EE
mK
AE
gS
ZA
zP
zP
Tx
Qs
Pe
no
bs
yb
zP
sv
"}
(8,1,1) = {"
ZA
zP
zP
KA
zP
zP
zP
zP
zP
EE
aM
Vx
qj
bK
eJ
yb
AP
Ho
"}
(9,1,1) = {"
zP
zP
AL
AL
AL
Ol
me
zP
fK
yb
Kv
MY
ag
Vz
Sd
yb
AP
lk
"}
(10,1,1) = {"
zP
fe
AL
iY
ii
AL
gW
TL
cH
yb
CK
MH
Iu
Po
af
hN
zP
lk
"}
(11,1,1) = {"
zP
jv
li
aH
FX
AL
py
zP
NJ
yb
Kv
ia
qj
bK
eJ
yb
dT
lk
"}
(12,1,1) = {"
zP
zP
zP
Gm
FX
zP
zP
zP
hQ
EE
cf
fx
ag
Vz
Sd
yb
dT
lk
"}
(13,1,1) = {"
ZA
ZA
zP
zP
zP
zP
ql
oF
hQ
hQ
Tx
yb
uv
yb
yb
yb
zP
wV
"}
(14,1,1) = {"
ZA
ZA
ZA
zP
gS
ql
QP
ql
kP
hQ
GR
eI
Xq
zP
Lr
Lr
zP
Qz
"}
(15,1,1) = {"
ZA
ZA
ZA
ZA
gS
ql
lT
Bw
ql
zP
zP
zP
NV
zP
zP
zP
zP
Ho
"}
(16,1,1) = {"
ZA
ZA
ZA
ZA
gS
gS
zF
ql
ql
hQ
rJ
JH
ys
pO
zP
ZA
sH
Ho
"}
(17,1,1) = {"
ZA
ZA
ZA
ZA
ZA
gS
gS
ql
vp
hQ
fb
Dx
dw
uP
sH
ZA
zP
zP
"}
(18,1,1) = {"
ZA
ZA
ZA
ZA
ZA
ZA
zP
zP
zP
zP
IW
zP
RN
zP
zP
ZA
ZA
ZA
"}
