//MAP CONVERTED BY dmm2tgm.py THIS HEADER COMMENT PREVENTS RECONVERSION, DO NOT REMOVE
"aG" = (
/obj/structure/fake_stairs/wood/directional/north,
/obj/structure/railing/wooden_fence{
	dir = 8
	},
/obj/effect/turf_decal/siding/wood{
	dir = 10
	},
/turf/open/floor/wood,
/area/misc/condo)
"eT" = (
/obj/structure/bedsheetbin/basket,
/turf/open/misc/beach/sand,
/area/misc/condo)
"fb" = (
/obj/structure/chair/wood,
/turf/open/misc/grass/jungle/station,
/area/misc/condo)
"fq" = (
/turf/open/misc/grass/jungle/station,
/area/misc/condo)
"fJ" = (
/obj/structure/flora/tree/jungle/small/style_2,
/turf/open/misc/grass/jungle/station,
/area/misc/condo)
"fU" = (
/obj/effect/turf_decal/siding/wood{
	dir = 10
	},
/obj/structure/railing/wooden_fence{
	dir = 8
	},
/turf/open/floor/wood/parquet,
/area/misc/condo)
"hR" = (
/obj/structure/bonfire/prelit,
/obj/effect/turf_decal/siding/wideplating_new/corner,
/obj/effect/turf_decal/siding/wideplating_new/corner{
	dir = 1
	},
/obj/effect/turf_decal/siding/wideplating_new/corner{
	dir = 4
	},
/obj/effect/turf_decal/siding/wideplating_new/corner{
	dir = 8
	},
/turf/open/floor/stone,
/area/misc/condo)
"ie" = (
/obj/effect/turf_decal/siding/wood{
	dir = 10
	},
/obj/structure/bed/dogbed,
/turf/open/floor/stone,
/area/misc/condo)
"iK" = (
/obj/structure/flora/bush/jungle/c/style_2,
/turf/open/misc/grass/jungle/station,
/area/misc/condo)
"jT" = (
/obj/structure/chair/wood{
	dir = 4
	},
/turf/open/misc/grass/jungle/station,
/area/misc/condo)
"jW" = (
/obj/effect/turf_decal/siding/wideplating_new/end{
	dir = 4
	},
/turf/open/floor/stone,
/area/misc/condo)
"kl" = (
/obj/effect/turf_decal/siding/wood,
/obj/effect/light_emitter/fake_outdoors,
/turf/open/floor/wood/parquet,
/area/misc/condo)
"kn" = (
/obj/structure/bed/double,
/obj/item/bedsheet/brown/double,
/turf/open/floor/wood/large,
/area/misc/condo)
"kt" = (
/turf/open/misc/dirt/jungle/wasteland,
/area/misc/condo)
"mv" = (
/obj/structure/closet/cabinet,
/turf/open/floor/wood/large,
/area/misc/condo)
"mE" = (
/obj/effect/light_emitter/fake_outdoors,
/turf/open/misc/grass/jungle/station,
/area/misc/condo)
"ng" = (
/obj/structure/flora/bush/reed/style_3,
/turf/open/misc/dirt/station,
/area/misc/condo)
"pu" = (
/obj/effect/turf_decal/siding/wood{
	dir = 8
	},
/obj/effect/turf_decal/siding/wood{
	dir = 4
	},
/obj/structure/barricade/wooden{
	dir = 4;
	name = "latticed window"
	},
/turf/open/floor/wood/large,
/area/misc/condo)
"pZ" = (
/turf/open/misc/dirt/jungle,
/area/misc/condo)
"qE" = (
/obj/structure/flora/bush/jungle/a/style_3,
/turf/open/misc/grass/jungle/station,
/area/misc/condo)
"qT" = (
/obj/structure/fireplace{
	pixel_y = 1
	},
/obj/effect/turf_decal/siding/wood,
/turf/open/floor/stone,
/area/misc/condo)
"rJ" = (
/turf/open/misc/beach/sand,
/area/misc/condo)
"sH" = (
/obj/effect/turf_decal/siding/wood{
	dir = 6
	},
/obj/structure/rack/skeletal,
/turf/open/floor/stone,
/area/misc/condo)
"sP" = (
/obj/structure/flora/bush/flowers_br,
/turf/open/misc/grass/jungle/station,
/area/misc/condo)
"tK" = (
/turf/open/floor/wood/parquet,
/area/misc/condo)
"tO" = (
/obj/structure/chair/wood{
	dir = 4
	},
/turf/open/floor/wood/large,
/area/misc/condo)
"vn" = (
/turf/closed/indestructible/weeb,
/area/misc/condo)
"vB" = (
/obj/structure/flora/bush/lavendergrass/style_random,
/turf/open/misc/dirt/jungle/dark,
/area/misc/condo)
"wi" = (
/obj/structure/fake_stairs/wood/directional/north,
/obj/effect/turf_decal/siding/wood,
/turf/open/floor/wood,
/area/misc/condo)
"xv" = (
/obj/item/reagent_containers/cup/bucket/wooden,
/turf/open/misc/beach/sand,
/area/misc/condo)
"xY" = (
/obj/item/kirbyplants/random,
/turf/open/floor/wood/large,
/area/misc/condo)
"yV" = (
/obj/effect/light_emitter/fake_outdoors,
/turf/open/misc/dirt/jungle/wasteland,
/area/misc/condo)
"zf" = (
/turf/closed/indestructible/hoteldoor/fakedoor/travel_tile,
/area/misc/condo)
"zx" = (
/obj/effect/turf_decal/siding/wideplating_new/end{
	dir = 1
	},
/turf/open/floor/stone,
/area/misc/condo)
"An" = (
/turf/open/floor/wood/tile,
/area/misc/condo)
"Aq" = (
/obj/structure/flora/bush/reed/style_2,
/turf/open/misc/dirt/jungle/dark,
/area/misc/condo)
"AH" = (
/obj/effect/turf_decal/siding/wood,
/obj/effect/turf_decal/siding/wood{
	dir = 1
	},
/obj/structure/mineral_door/wood,
/turf/open/floor/wood/large,
/area/misc/condo)
"Br" = (
/turf/open/floor/wood/large,
/area/misc/condo)
"FN" = (
/obj/structure/flora/bush/reed,
/turf/open/misc/dirt/station,
/area/misc/condo)
"GA" = (
/turf/template_noop,
/area/template_noop)
"HS" = (
/obj/effect/turf_decal/siding/wood{
	dir = 10
	},
/obj/structure/railing/wooden_fence{
	dir = 8
	},
/obj/structure/railing/wooden_fence,
/obj/structure/chair/wood{
	dir = 4
	},
/turf/open/floor/wood/parquet,
/area/misc/condo)
"Jo" = (
/turf/closed/indestructible/rock,
/area/misc/condo)
"KM" = (
/obj/structure/flora/bush/reed/style_4,
/turf/open/misc/dirt/station,
/area/misc/condo)
"Mj" = (
/obj/effect/turf_decal/siding/wood/corner{
	dir = 8
	},
/turf/open/floor/wood/parquet,
/area/misc/condo)
"Mo" = (
/turf/closed/indestructible/wood,
/area/misc/condo)
"MP" = (
/turf/open/misc/dirt/station,
/area/misc/condo)
"Nk" = (
/obj/effect/turf_decal/siding/wood,
/obj/structure/railing/wooden_fence,
/obj/structure/table/wood,
/turf/open/floor/wood/parquet,
/area/misc/condo)
"NV" = (
/obj/structure/flora/tree/jungle/style_4,
/turf/open/misc/grass/jungle/station,
/area/misc/condo)
"OP" = (
/obj/structure/flora/tree/jungle/small/style_4,
/turf/open/misc/grass/jungle/station,
/area/misc/condo)
"OU" = (
/obj/effect/turf_decal/siding/wideplating_new/end,
/turf/open/floor/stone,
/area/misc/condo)
"PA" = (
/obj/structure/flora/bush/flowers_yw,
/turf/open/misc/grass/jungle/station,
/area/misc/condo)
"Se" = (
/obj/effect/turf_decal/siding/wood,
/obj/structure/railing/wooden_fence,
/obj/structure/chair/wood{
	dir = 8
	},
/turf/open/floor/wood/parquet,
/area/misc/condo)
"SH" = (
/obj/structure/dresser,
/turf/open/floor/wood/large,
/area/misc/condo)
"TG" = (
/obj/effect/light_emitter/fake_outdoors,
/turf/open/misc/dirt/jungle/dark,
/area/misc/condo)
"Ud" = (
/obj/structure/flora/bush/flowers_pp,
/turf/open/misc/grass/jungle/station,
/area/misc/condo)
"UE" = (
/obj/structure/flora/bush/fullgrass/style_random,
/turf/open/misc/beach/sand,
/area/misc/condo)
"UJ" = (
/turf/open/misc/dirt/jungle/dark,
/area/misc/condo)
"UZ" = (
/obj/effect/turf_decal/siding/wideplating_new/end{
	dir = 8
	},
/turf/open/floor/stone,
/area/misc/condo)
"WG" = (
/obj/effect/planetary_turf_atmos_helper,
/turf/closed/indestructible/wood,
/area/misc/condo)
"Xl" = (
/turf/open/water/jungle,
/area/misc/condo)

(1,1,1) = {"
GA
GA
GA
GA
GA
Jo
Jo
Jo
Jo
Jo
pZ
zf
pZ
Jo
Jo
"}
(2,1,1) = {"
GA
GA
GA
GA
Jo
Jo
Xl
Xl
UJ
vB
fq
pZ
fq
sP
Jo
"}
(3,1,1) = {"
GA
GA
Jo
Jo
Jo
Xl
Xl
KM
UJ
rJ
fq
mE
pZ
pZ
Jo
"}
(4,1,1) = {"
GA
Jo
Jo
Xl
Xl
Xl
rJ
rJ
fq
NV
fq
fq
fq
pZ
Jo
"}
(5,1,1) = {"
Jo
Jo
Xl
Xl
Xl
ng
TG
fq
fq
fq
fq
fq
OP
fq
Jo
"}
(6,1,1) = {"
Jo
Xl
Xl
Xl
MP
fq
rJ
fq
UZ
jT
fq
fq
pZ
Jo
Jo
"}
(7,1,1) = {"
Jo
Xl
rJ
UE
fq
OP
fq
zx
hR
OU
fq
pZ
fq
Jo
GA
"}
(8,1,1) = {"
Jo
FN
eT
fq
rJ
fq
iK
fb
jW
fq
Ud
fq
pZ
Jo
GA
"}
(9,1,1) = {"
Jo
xv
fq
mE
fq
fq
fq
fq
fq
fq
pZ
pZ
fq
Jo
GA
"}
(10,1,1) = {"
Mo
Mo
pu
pu
Mo
WG
fU
aG
pZ
fq
pZ
fq
fq
Jo
Jo
"}
(11,1,1) = {"
vn
xY
An
Br
An
AH
kl
wi
pZ
pZ
fq
fJ
PA
kt
Jo
"}
(12,1,1) = {"
vn
ie
tO
An
Br
Mo
Mj
HS
qE
fq
fq
yV
kt
UJ
Jo
"}
(13,1,1) = {"
Mo
qT
An
Br
An
vn
tK
Nk
fq
kt
kt
kt
Jo
Jo
Jo
"}
(14,1,1) = {"
vn
sH
Br
An
kn
vn
tK
Se
kt
kt
kt
kt
Jo
GA
GA
"}
(15,1,1) = {"
vn
mv
An
SH
Mo
Mo
Jo
Jo
kt
Aq
kt
Jo
Jo
GA
GA
"}
(16,1,1) = {"
Mo
Mo
Mo
Mo
Mo
GA
GA
Jo
Jo
Jo
Jo
Jo
GA
GA
GA
"}
