//MAP CONVERTED BY dmm2tgm.py THIS HEADER COMMENT PREVENTS RECONVERSION, DO NOT REMOVE
"a" = (
/turf/closed/indestructible/normal_wall,
/area/misc/condo)
"b" = (
/obj/structure/dresser,
/obj/structure/sign/poster/random/directional/north,
/turf/open/floor/carpet/royalblue,
/area/misc/condo)
"c" = (
/obj/structure/table/wood,
/obj/item/paper_bin{
	pixel_y = 8
	},
/turf/open/floor/carpet/royalblue,
/area/misc/condo)
"d" = (
/obj/effect/planetary_turf_atmos_helper,
/turf/closed/indestructible/normal_wall,
/area/misc/condo)
"f" = (
/obj/structure/table,
/obj/machinery/light/directional/north,
/obj/effect/turf_decal/siding/thinplating/dark{
	dir = 4
	},
/turf/open/floor/iron/dark,
/area/misc/condo)
"h" = (
/obj/structure/fluff/fake_vent,
/turf/open/floor/carpet/royalblue,
/area/misc/condo)
"j" = (
/obj/structure/table/wood,
/turf/open/floor/carpet/royalblue,
/area/misc/condo)
"n" = (
/obj/structure/table,
/obj/item/screwdriver,
/turf/open/floor/iron/dark,
/area/misc/condo)
"t" = (
/turf/cordon,
/area/misc/condo)
"u" = (
/obj/effect/turf_decal/siding/thinplating/dark{
	dir = 4
	},
/turf/open/floor/iron/dark,
/area/misc/condo)
"B" = (
/obj/structure/sink/directional/east,
/obj/structure/mirror/directional/west,
/obj/structure/fluff/fake_scrubber,
/turf/open/floor/iron/dark,
/area/misc/condo)
"D" = (
/obj/structure/closet/secure_closet/personal,
/turf/open/floor/iron/dark,
/area/misc/condo)
"P" = (
/turf/open/floor/iron/dark,
/area/misc/condo)
"Q" = (
/turf/open/floor/carpet/royalblue,
/area/misc/condo)
"S" = (
/turf/closed/indestructible/hoteldoor/fakedoor,
/area/misc/condo)
"X" = (
/obj/structure/table,
/obj/item/paper_bin{
	pixel_y = 8
	},
/obj/item/clothing/glasses/regular,
/obj/structure/fluff/fake_scrubber,
/turf/open/floor/iron/dark,
/area/misc/condo)
"Z" = (
/obj/machinery/light_switch/directional/north,
/obj/structure/bed/double,
/obj/item/bedsheet/blue/double,
/turf/open/floor/carpet/royalblue,
/area/misc/condo)

(1,1,1) = {"
d
a
a
a
a
t
"}
(2,1,1) = {"
a
X
B
D
a
t
"}
(3,1,1) = {"
a
n
P
P
S
t
"}
(4,1,1) = {"
a
f
u
u
a
a
"}
(5,1,1) = {"
a
b
Q
h
c
a
"}
(6,1,1) = {"
a
Z
Q
Q
j
a
"}
(7,1,1) = {"
a
a
a
a
a
a
"}
