//MAP CONVERTED BY dmm2tgm.py THIS HEADER COMMENT PREVENTS RECONVERSION, DO NOT REMOVE
"a" = (
/obj/effect/planetary_turf_atmos_helper,
/turf/closed/indestructible/iron,
/area/misc/condo)
"b" = (
/obj/effect/light_emitter/fake_outdoors,
/turf/open/misc/beach/sand,
/area/misc/condo)
"e" = (
/obj/structure/flora/tree/jungle/style_5,
/turf/open/misc/grass/jungle/station,
/area/misc/condo)
"f" = (
/turf/closed/indestructible/hoteldoor/fakedoor,
/area/misc/condo)
"h" = (
/turf/open/misc/beach/sand,
/area/misc/condo)
"p" = (
/obj/structure/flora/tree/jungle/style_2,
/turf/open/misc/grass/jungle/station,
/area/misc/condo)
"r" = (
/turf/open/misc/grass/jungle/station,
/area/misc/condo)
"s" = (
/turf/closed/indestructible/rock,
/area/misc/condo)
"u" = (
/obj/effect/light_emitter/fake_outdoors,
/turf/open/water/jungle,
/area/misc/condo)
"v" = (
/turf/template_noop,
/area/template_noop)
"w" = (
/obj/structure/flora/tree/jungle/style_3,
/obj/effect/light_emitter/fake_outdoors,
/turf/open/misc/grass/jungle/station,
/area/misc/condo)
"y" = (
/obj/structure/flora/tree/jungle/small/style_5,
/turf/open/misc/grass/jungle/station,
/area/misc/condo)
"D" = (
/turf/open/water/jungle,
/area/misc/condo)
"F" = (
/obj/structure/flora/tree/jungle/small/style_2,
/turf/open/misc/grass/jungle/station,
/area/misc/condo)
"G" = (
/turf/closed/indestructible/iron,
/area/misc/condo)
"K" = (
/turf/open/misc/dirt/station,
/area/misc/condo)
"M" = (
/turf/open/misc/dirt/dark/station,
/area/misc/condo)
"N" = (
/obj/structure/flora/tree/jungle/small/style_2,
/obj/effect/light_emitter/fake_outdoors,
/turf/open/misc/dirt/station,
/area/misc/condo)
"O" = (
/obj/structure/flora/tree/jungle/small/style_4,
/turf/open/misc/grass/jungle/station,
/area/misc/condo)

(1,1,1) = {"
v
v
s
s
s
s
s
G
G
G
G
G
G
G
G
"}
(2,1,1) = {"
v
s
s
D
D
D
D
D
D
D
K
K
r
r
G
"}
(3,1,1) = {"
s
s
D
D
D
D
D
D
D
K
M
r
r
F
G
"}
(4,1,1) = {"
s
D
D
D
D
u
D
D
D
K
K
w
r
r
G
"}
(5,1,1) = {"
s
D
D
D
D
D
D
D
D
h
h
K
y
r
G
"}
(6,1,1) = {"
s
D
D
D
D
D
D
D
h
h
h
K
r
r
G
"}
(7,1,1) = {"
s
D
D
D
D
D
D
D
h
h
h
r
r
r
a
"}
(8,1,1) = {"
s
D
D
D
D
D
D
D
b
h
K
r
r
r
f
"}
(9,1,1) = {"
s
s
D
D
D
D
D
h
h
h
K
e
r
r
G
"}
(10,1,1) = {"
v
s
D
D
D
D
D
h
h
h
h
r
p
r
G
"}
(11,1,1) = {"
v
s
D
D
D
D
D
h
h
h
h
K
r
r
G
"}
(12,1,1) = {"
v
s
s
D
D
u
D
D
h
h
h
N
r
r
G
"}
(13,1,1) = {"
v
v
s
D
D
D
D
D
K
h
h
r
O
r
G
"}
(14,1,1) = {"
v
v
s
s
D
D
D
D
D
K
M
r
r
r
G
"}
(15,1,1) = {"
v
v
v
s
s
s
s
G
G
G
G
G
G
G
G
"}
