//MAP CONVERTED BY dmm2tgm.py THIS HEADER COMMENT PREVENTS RECONVERSION, DO NOT REMOVE
"aN" = (
/obj/structure/curtain/cloth/fancy,
/turf/closed/indestructible/fakeglass,
/area/misc/condo)
"aU" = (
/obj/structure/closet/mini_fridge,
/obj/effect/turf_decal/siding/wood,
/turf/open/floor/iron/kitchen,
/area/misc/condo)
"bb" = (
/obj/effect/turf_decal/tile/dark_blue/diagonal_centre,
/obj/effect/turf_decal/siding/white{
	dir = 4
	},
/obj/structure/fluff/fake_vent,
/turf/open/floor/iron/white/diagonal,
/area/misc/condo)
"fv" = (
/obj/effect/turf_decal/siding/wideplating_new{
	dir = 8
	},
/obj/effect/turf_decal/siding/wideplating_new{
	dir = 4
	},
/obj/machinery/door/airlock{
	dir = 4
	},
/obj/effect/mapping_helpers/airlock/autoname,
/turf/open/floor/iron/smooth_large,
/area/misc/condo)
"fH" = (
/obj/effect/turf_decal/trimline/dark/filled/line{
	dir = 6
	},
/obj/effect/turf_decal/trimline/dark/filled/mid_joiner,
/obj/effect/turf_decal/trimline/dark/filled/mid_joiner{
	dir = 4
	},
/turf/open/floor/iron/diagonal,
/area/misc/condo)
"fV" = (
/obj/structure/table,
/obj/machinery/microwave{
	pixel_y = 8
	},
/obj/effect/turf_decal/siding/wood{
	dir = 4
	},
/turf/open/floor/iron/kitchen,
/area/misc/condo)
"gj" = (
/obj/effect/turf_decal/tile/dark_blue/diagonal_centre,
/obj/structure/toilet,
/obj/machinery/light/directional/west,
/turf/open/floor/iron/white/diagonal,
/area/misc/condo)
"gT" = (
/obj/structure/fluff/fake_vent,
/obj/effect/turf_decal/siding/wood{
	dir = 10
	},
/turf/open/floor/wood/large,
/area/misc/condo)
"hi" = (
/obj/effect/turf_decal/siding/thinplating_new{
	dir = 4
	},
/obj/structure/hedge,
/obj/effect/turf_decal/trimline/dark/filled/line,
/obj/effect/turf_decal/trimline/dark/filled/mid_joiner,
/obj/effect/turf_decal/trimline/dark/filled/mid_joiner{
	pixel_x = 16
	},
/turf/open/floor/iron/dark,
/area/misc/condo)
"ig" = (
/obj/structure/dresser,
/turf/open/floor/wood/parquet,
/area/misc/condo)
"is" = (
/turf/open/floor/carpet/red,
/area/misc/condo)
"lx" = (
/obj/machinery/light_switch/directional/east,
/obj/structure/closet/cabinet,
/obj/machinery/light/small/directional/north,
/turf/open/floor/carpet/red,
/area/misc/condo)
"me" = (
/turf/closed/indestructible/normal_wall,
/area/misc/condo)
"mM" = (
/obj/effect/spawner/liquids_spawner,
/obj/machinery/plumbing/floor_pump/output/on/supply/waist_deep/directional/west,
/turf/open/floor/iron/pool,
/area/misc/condo)
"po" = (
/turf/closed/indestructible/fakeglass,
/area/misc/condo)
"qK" = (
/obj/effect/turf_decal/siding/white,
/obj/machinery/shower/directional/south,
/obj/structure/curtain,
/obj/structure/drain,
/turf/open/floor/iron/freezer,
/area/misc/condo)
"sK" = (
/obj/item/kirbyplants/random,
/turf/open/floor/carpet/black,
/area/misc/condo)
"uZ" = (
/obj/machinery/light/directional/west,
/obj/structure/chair/sofa/left/brown{
	dir = 4
	},
/turf/open/floor/wood,
/area/misc/condo)
"vm" = (
/turf/open/floor/wood/tile,
/area/misc/condo)
"vA" = (
/obj/structure/aquarium,
/turf/open/floor/wood/parquet,
/area/misc/condo)
"vX" = (
/obj/effect/turf_decal/siding/wideplating_new{
	dir = 1
	},
/obj/effect/turf_decal/siding/wideplating_new,
/obj/machinery/door/airlock/silver{
	name = "Bathroom"
	},
/turf/open/floor/iron/smooth_large,
/area/misc/condo)
"wi" = (
/obj/effect/turf_decal/trimline/neutral/corner{
	dir = 4
	},
/obj/effect/turf_decal/trimline/dark/filled/line,
/obj/effect/turf_decal/trimline/dark/filled/mid_joiner,
/obj/effect/turf_decal/trimline/dark/filled/mid_joiner{
	pixel_x = 16
	},
/turf/open/floor/iron/diagonal,
/area/misc/condo)
"wA" = (
/obj/machinery/light/directional/south,
/obj/machinery/computer/old{
	dir = 1
	},
/turf/open/floor/wood/parquet,
/area/misc/condo)
"wN" = (
/obj/structure/fluff/fake_scrubber,
/turf/open/floor/wood,
/area/misc/condo)
"xb" = (
/obj/machinery/computer/security/telescreen/entertainment/directional/east,
/obj/structure/table/wood,
/turf/open/floor/wood,
/area/misc/condo)
"yd" = (
/obj/effect/turf_decal/trimline/dark/filled/line,
/obj/effect/turf_decal/trimline/dark/filled/mid_joiner,
/obj/effect/turf_decal/trimline/dark/filled/mid_joiner{
	pixel_x = 16
	},
/turf/open/floor/iron/diagonal,
/area/misc/condo)
"yM" = (
/obj/effect/turf_decal/siding/wood{
	dir = 6
	},
/turf/open/floor/iron/kitchen,
/area/misc/condo)
"zl" = (
/obj/structure/table,
/obj/item/storage/box/donkpockets{
	pixel_y = 5
	},
/turf/open/floor/iron/kitchen,
/area/misc/condo)
"zo" = (
/obj/structure/table,
/obj/item/plate{
	pixel_y = 2
	},
/obj/item/plate{
	pixel_y = 8
	},
/obj/item/plate{
	pixel_y = 13
	},
/obj/item/knife/plastic{
	pixel_x = 14;
	pixel_y = 13
	},
/obj/item/knife/plastic{
	pixel_x = 14;
	pixel_y = 9
	},
/obj/item/knife/plastic{
	pixel_x = 14;
	pixel_y = 5
	},
/obj/item/kitchen/fork/plastic{
	pixel_x = -12;
	pixel_y = 14
	},
/obj/item/kitchen/fork/plastic{
	pixel_x = -12;
	pixel_y = 11
	},
/obj/item/kitchen/fork/plastic{
	pixel_x = -12;
	pixel_y = 5
	},
/turf/open/floor/iron/kitchen,
/area/misc/condo)
"zE" = (
/obj/structure/chair/sofa/right/brown{
	dir = 1
	},
/turf/open/floor/wood,
/area/misc/condo)
"Ao" = (
/turf/open/floor/wood/parquet,
/area/misc/condo)
"BM" = (
/obj/structure/rack,
/turf/open/floor/wood/large,
/area/misc/condo)
"BT" = (
/obj/effect/turf_decal/siding/wood{
	dir = 1
	},
/obj/structure/hedge,
/turf/open/floor/iron/dark/textured_large,
/area/misc/condo)
"Dr" = (
/obj/machinery/light/small/directional/north,
/turf/open/floor/wood/tile,
/area/misc/condo)
"Dv" = (
/obj/effect/turf_decal/trimline/neutral/corner{
	dir = 1
	},
/obj/effect/turf_decal/trimline/dark/filled/line,
/obj/effect/turf_decal/trimline/dark/filled/mid_joiner,
/obj/effect/turf_decal/trimline/dark/filled/mid_joiner{
	pixel_x = 16
	},
/turf/open/floor/iron/diagonal,
/area/misc/condo)
"Ee" = (
/obj/item/kirbyplants/random,
/turf/open/floor/carpet/red,
/area/misc/condo)
"Er" = (
/obj/effect/turf_decal/trimline/dark/filled/line,
/obj/effect/turf_decal/trimline/dark/filled/mid_joiner,
/obj/effect/turf_decal/trimline/dark/filled/mid_joiner{
	pixel_x = 16
	},
/obj/machinery/light/built/directional/north,
/turf/open/floor/iron/diagonal,
/area/misc/condo)
"FV" = (
/obj/effect/turf_decal/siding/wood{
	dir = 5
	},
/obj/structure/table/wood,
/obj/item/flashlight/lamp/green{
	pixel_y = 8
	},
/turf/open/floor/wood/large,
/area/misc/condo)
"Gs" = (
/obj/effect/turf_decal/trimline/dark/filled/line{
	dir = 4
	},
/obj/effect/turf_decal/trimline/dark/filled/mid_joiner{
	dir = 4
	},
/obj/effect/turf_decal/trimline/dark/filled/mid_joiner{
	dir = 4;
	pixel_y = -16
	},
/turf/open/floor/iron/diagonal,
/area/misc/condo)
"GF" = (
/turf/cordon,
/area/misc/condo)
"Hj" = (
/obj/effect/turf_decal/siding/wood{
	dir = 9
	},
/obj/structure/bed/dogbed,
/turf/open/floor/wood/large,
/area/misc/condo)
"Hw" = (
/obj/structure/fluff/fake_vent,
/obj/effect/turf_decal/trimline/dark/filled/line{
	dir = 4
	},
/obj/effect/turf_decal/trimline/dark/filled/mid_joiner{
	dir = 4
	},
/obj/effect/turf_decal/trimline/dark/filled/mid_joiner{
	dir = 4;
	pixel_y = -16
	},
/turf/open/floor/iron/diagonal,
/area/misc/condo)
"HZ" = (
/turf/open/floor/carpet/black,
/area/misc/condo)
"IJ" = (
/turf/open/floor/wood,
/area/misc/condo)
"Ly" = (
/obj/effect/turf_decal/siding/wood{
	dir = 6
	},
/obj/structure/bed/double,
/obj/effect/spawner/random/bedsheet/double,
/turf/open/floor/wood/large,
/area/misc/condo)
"Ml" = (
/obj/structure/closet/secure_closet/personal/cabinet,
/turf/open/floor/wood/large,
/area/misc/condo)
"Mr" = (
/turf/closed/indestructible/hoteldoor/fakedoor,
/area/misc/condo)
"Ry" = (
/obj/effect/turf_decal/tile/dark_blue/diagonal_centre,
/obj/effect/turf_decal/siding/white{
	dir = 4
	},
/turf/open/floor/iron/white/diagonal,
/area/misc/condo)
"RV" = (
/obj/effect/spawner/liquids_spawner,
/turf/open/floor/iron/pool,
/area/misc/condo)
"SD" = (
/obj/structure/fluff/fake_scrubber,
/obj/structure/chair/office/light,
/turf/open/floor/wood/parquet,
/area/misc/condo)
"TQ" = (
/obj/effect/turf_decal/tile/dark_blue/diagonal_centre,
/obj/structure/sink/directional/east,
/obj/structure/mirror/directional/west,
/obj/structure/fluff/fake_scrubber,
/turf/open/floor/iron/white/diagonal,
/area/misc/condo)
"Vl" = (
/obj/effect/turf_decal/trimline/neutral/line{
	dir = 1
	},
/obj/effect/turf_decal/trimline/dark/filled/line,
/obj/effect/turf_decal/trimline/dark/filled/mid_joiner,
/obj/effect/turf_decal/trimline/dark/filled/mid_joiner{
	pixel_x = 16
	},
/turf/open/floor/iron/diagonal,
/area/misc/condo)
"Vw" = (
/obj/effect/turf_decal/siding/wideplating_new{
	dir = 8
	},
/obj/effect/turf_decal/siding/wideplating_new{
	dir = 4
	},
/obj/machinery/door/airlock/grunge{
	dir = 4
	},
/obj/effect/mapping_helpers/airlock/autoname,
/turf/open/floor/iron/smooth_large,
/area/misc/condo)
"Wt" = (
/obj/structure/table/wood,
/obj/effect/spawner/random/bureaucracy/paper{
	pixel_y = 8
	},
/obj/effect/spawner/random/bureaucracy/pen{
	pixel_y = 8
	},
/turf/open/floor/wood/parquet,
/area/misc/condo)
"Xj" = (
/obj/structure/fluff/fake_vent,
/obj/effect/turf_decal/siding/wood{
	dir = 4
	},
/turf/open/floor/iron/kitchen,
/area/misc/condo)
"Xo" = (
/obj/structure/table/wood,
/turf/open/floor/wood/parquet,
/area/misc/condo)
"XD" = (
/obj/structure/chair/sofa/corner/brown{
	dir = 1
	},
/turf/open/floor/wood,
/area/misc/condo)
"Zm" = (
/obj/effect/planetary_turf_atmos_helper,
/turf/closed/indestructible/normal_wall,
/area/misc/condo)

(1,1,1) = {"
GF
GF
GF
GF
me
me
me
me
me
me
me
me
GF
"}
(2,1,1) = {"
GF
Zm
me
me
me
zl
zo
aU
IJ
uZ
XD
me
me
"}
(3,1,1) = {"
me
me
gj
TQ
me
fV
Xj
yM
wN
xb
zE
BT
me
"}
(4,1,1) = {"
me
qK
bb
Ry
vX
IJ
IJ
IJ
IJ
me
IJ
me
me
"}
(5,1,1) = {"
me
me
mM
RV
me
me
Vw
me
is
is
is
aN
hi
"}
(6,1,1) = {"
GF
me
me
me
me
sK
HZ
me
lx
is
Ee
aN
yd
"}
(7,1,1) = {"
GF
GF
GF
me
vA
HZ
HZ
me
me
fv
me
me
wi
"}
(8,1,1) = {"
GF
GF
me
me
Ao
Ao
SD
wA
me
Dr
vm
Mr
Vl
"}
(9,1,1) = {"
GF
GF
me
Hj
gT
ig
Xo
Wt
me
BM
Ml
me
Dv
"}
(10,1,1) = {"
GF
GF
me
FV
Ly
me
me
me
me
po
me
me
Er
"}
(11,1,1) = {"
GF
GF
me
me
me
me
GF
GF
me
Gs
Hw
Gs
fH
"}
