//MAP CONVERTED BY dmm2tgm.py THIS HEADER COMMENT PREVENTS RECONVERSION, DO NOT REMOVE
"aN" = (
/obj/effect/spawner/structure/window/reinforced/indestructible,
/obj/structure/curtain/cloth/fancy,
/turf/open/floor/plating,
/area/space)
"aU" = (
/obj/structure/closet/mini_fridge,
/turf/open/floor/iron/kitchen,
/area/space)
"bb" = (
/obj/effect/turf_decal/tile/dark_blue/diagonal_centre,
/obj/effect/turf_decal/siding/white{
	dir = 4
	},
/obj/structure/fluff/fake_vent,
/turf/open/floor/iron/white/diagonal,
/area/space)
"bn" = (
/turf/template_noop,
/area/template_noop)
"fv" = (
/obj/effect/turf_decal/siding/wideplating_new{
	dir = 8
	},
/obj/effect/turf_decal/siding/wideplating_new{
	dir = 4
	},
/obj/machinery/door/airlock{
	dir = 4
	},
/obj/effect/mapping_helpers/airlock/autoname,
/turf/open/floor/iron/smooth_large,
/area/space)
"fH" = (
/obj/effect/turf_decal/trimline/dark/filled/line{
	dir = 6
	},
/obj/effect/turf_decal/trimline/dark/filled/mid_joiner,
/obj/effect/turf_decal/trimline/dark/filled/mid_joiner{
	dir = 4
	},
/turf/open/floor/iron/diagonal,
/area/space)
"fV" = (
/obj/structure/table,
/obj/machinery/microwave{
	pixel_y = 8
	},
/turf/open/floor/iron/kitchen,
/area/space)
"gj" = (
/obj/effect/turf_decal/tile/dark_blue/diagonal_centre,
/obj/structure/toilet,
/obj/machinery/light/directional/west,
/turf/open/floor/iron/white/diagonal,
/area/space)
"gT" = (
/obj/structure/fluff/fake_vent,
/obj/effect/turf_decal/siding/wood{
	dir = 10
	},
/turf/open/floor/wood/large,
/area/space)
"hi" = (
/obj/effect/turf_decal/siding/thinplating_new{
	dir = 4
	},
/obj/structure/hedge,
/obj/effect/turf_decal/trimline/dark/filled/line,
/obj/effect/turf_decal/trimline/dark/filled/mid_joiner,
/obj/effect/turf_decal/trimline/dark/filled/mid_joiner{
	pixel_x = 16
	},
/turf/open/floor/iron/dark,
/area/space)
"ig" = (
/obj/structure/dresser,
/turf/open/floor/wood/parquet,
/area/space)
"is" = (
/turf/open/floor/carpet/red,
/area/space)
"lx" = (
/obj/machinery/light_switch/directional/east,
/obj/structure/closet/cabinet,
/obj/machinery/light/small/directional/north,
/turf/open/floor/carpet/red,
/area/space)
"me" = (
/turf/closed/indestructible,
/area/space)
"mM" = (
/obj/effect/spawner/liquids_spawner,
/obj/machinery/plumbing/floor_pump/output/on/supply/waist_deep/directional/west,
/turf/open/floor/iron/pool,
/area/space)
"po" = (
/obj/effect/spawner/structure/window/reinforced/indestructible,
/turf/open/floor/plating,
/area/space)
"qK" = (
/obj/effect/turf_decal/siding/white,
/obj/machinery/shower/directional/south,
/obj/structure/curtain,
/obj/structure/drain,
/turf/open/floor/iron/freezer,
/area/space)
"sK" = (
/obj/item/kirbyplants/random,
/turf/open/floor/carpet/black,
/area/space)
"uZ" = (
/obj/machinery/light/directional/west,
/obj/structure/chair/sofa/left/brown{
	dir = 4
	},
/turf/open/floor/wood,
/area/space)
"vm" = (
/turf/open/floor/wood/tile,
/area/space)
"vA" = (
/obj/structure/aquarium,
/turf/open/floor/wood/parquet,
/area/space)
"vX" = (
/obj/effect/turf_decal/siding/wideplating_new{
	dir = 1
	},
/obj/effect/turf_decal/siding/wideplating_new,
/obj/machinery/door/airlock/silver{
	name = "Bathroom"
	},
/turf/open/floor/iron/smooth_large,
/area/space)
"wi" = (
/obj/effect/turf_decal/trimline/neutral/corner{
	dir = 4
	},
/obj/effect/turf_decal/trimline/dark/filled/line,
/obj/effect/turf_decal/trimline/dark/filled/mid_joiner,
/obj/effect/turf_decal/trimline/dark/filled/mid_joiner{
	pixel_x = 16
	},
/turf/open/floor/iron/diagonal,
/area/space)
"wA" = (
/obj/machinery/light/directional/south,
/obj/machinery/computer/old{
	dir = 1
	},
/turf/open/floor/wood/parquet,
/area/space)
"wN" = (
/obj/structure/fluff/fake_scrubber,
/turf/open/floor/wood,
/area/space)
"xb" = (
/obj/machinery/computer/security/telescreen/entertainment/directional/east,
/obj/structure/table/wood,
/turf/open/floor/wood,
/area/space)
"yd" = (
/obj/effect/turf_decal/trimline/dark/filled/line,
/obj/effect/turf_decal/trimline/dark/filled/mid_joiner,
/obj/effect/turf_decal/trimline/dark/filled/mid_joiner{
	pixel_x = 16
	},
/turf/open/floor/iron/diagonal,
/area/space)
"yM" = (
/turf/open/floor/iron/kitchen,
/area/space)
"zl" = (
/obj/structure/table,
/obj/item/storage/box/donkpockets{
	pixel_y = 5
	},
/turf/open/floor/iron/kitchen,
/area/space)
"zo" = (
/obj/structure/table,
/obj/item/plate{
	pixel_y = 2
	},
/obj/item/plate{
	pixel_y = 8
	},
/obj/item/plate{
	pixel_y = 13
	},
/obj/item/knife/plastic{
	pixel_x = 14;
	pixel_y = 13
	},
/obj/item/knife/plastic{
	pixel_x = 14;
	pixel_y = 9
	},
/obj/item/knife/plastic{
	pixel_x = 14;
	pixel_y = 5
	},
/obj/item/kitchen/fork/plastic{
	pixel_x = -12;
	pixel_y = 14
	},
/obj/item/kitchen/fork/plastic{
	pixel_x = -12;
	pixel_y = 11
	},
/obj/item/kitchen/fork/plastic{
	pixel_x = -12;
	pixel_y = 5
	},
/turf/open/floor/iron/kitchen,
/area/space)
"zE" = (
/obj/structure/chair/sofa/right/brown{
	dir = 1
	},
/turf/open/floor/wood,
/area/space)
"Ao" = (
/turf/open/floor/wood/parquet,
/area/space)
"BM" = (
/obj/structure/rack,
/turf/open/floor/wood/large,
/area/space)
"BT" = (
/obj/effect/turf_decal/siding/wood{
	dir = 1
	},
/obj/structure/hedge,
/turf/open/floor/iron/dark/textured_large,
/area/space)
"Dr" = (
/obj/machinery/light/small/directional/north,
/turf/open/floor/wood/tile,
/area/space)
"Dv" = (
/obj/effect/turf_decal/trimline/neutral/corner{
	dir = 1
	},
/obj/effect/turf_decal/trimline/dark/filled/line,
/obj/effect/turf_decal/trimline/dark/filled/mid_joiner,
/obj/effect/turf_decal/trimline/dark/filled/mid_joiner{
	pixel_x = 16
	},
/turf/open/floor/iron/diagonal,
/area/space)
"Ee" = (
/obj/item/kirbyplants/random,
/turf/open/floor/carpet/red,
/area/space)
"Er" = (
/obj/effect/turf_decal/trimline/dark/filled/line,
/obj/effect/turf_decal/trimline/dark/filled/mid_joiner,
/obj/effect/turf_decal/trimline/dark/filled/mid_joiner{
	pixel_x = 16
	},
/obj/machinery/light/built/directional/north,
/turf/open/floor/iron/diagonal,
/area/space)
"FV" = (
/obj/effect/turf_decal/siding/wood{
	dir = 5
	},
/obj/structure/table/wood,
/obj/item/flashlight/lamp/green{
	pixel_y = 8
	},
/turf/open/floor/wood/large,
/area/space)
"Gs" = (
/obj/effect/turf_decal/trimline/dark/filled/line{
	dir = 4
	},
/obj/effect/turf_decal/trimline/dark/filled/mid_joiner{
	dir = 4
	},
/obj/effect/turf_decal/trimline/dark/filled/mid_joiner{
	dir = 4;
	pixel_y = -16
	},
/turf/open/floor/iron/diagonal,
/area/space)
"GF" = (
/turf/closed/indestructible/binary,
/area/space)
"Hj" = (
/obj/effect/turf_decal/siding/wood{
	dir = 9
	},
/obj/structure/bed/dogbed,
/turf/open/floor/wood/large,
/area/space)
"Hw" = (
/obj/structure/fluff/fake_vent,
/obj/effect/turf_decal/trimline/dark/filled/line{
	dir = 4
	},
/obj/effect/turf_decal/trimline/dark/filled/mid_joiner{
	dir = 4
	},
/obj/effect/turf_decal/trimline/dark/filled/mid_joiner{
	dir = 4;
	pixel_y = -16
	},
/turf/open/floor/iron/diagonal,
/area/space)
"HZ" = (
/turf/open/floor/carpet/black,
/area/space)
"IJ" = (
/turf/open/floor/wood,
/area/space)
"Ly" = (
/obj/effect/turf_decal/siding/wood{
	dir = 6
	},
/obj/structure/bed/double,
/obj/effect/spawner/random/bedsheet/double,
/turf/open/floor/wood/large,
/area/space)
"Ml" = (
/obj/structure/closet/secure_closet/personal/cabinet,
/turf/open/floor/wood/large,
/area/space)
"Mr" = (
/turf/closed/indestructible/hoteldoor/fakedoor,
/area/space)
"Ry" = (
/obj/effect/turf_decal/tile/dark_blue/diagonal_centre,
/obj/effect/turf_decal/siding/white{
	dir = 4
	},
/turf/open/floor/iron/white/diagonal,
/area/space)
"RV" = (
/obj/effect/spawner/liquids_spawner,
/turf/open/floor/iron/pool,
/area/space)
"SD" = (
/obj/structure/fluff/fake_scrubber,
/obj/structure/chair/office/light,
/turf/open/floor/wood/parquet,
/area/space)
"TQ" = (
/obj/effect/turf_decal/tile/dark_blue/diagonal_centre,
/obj/structure/sink/directional/east,
/obj/structure/mirror/directional/west,
/obj/structure/fluff/fake_scrubber,
/turf/open/floor/iron/white/diagonal,
/area/space)
"Vl" = (
/obj/effect/turf_decal/trimline/neutral/line{
	dir = 1
	},
/obj/effect/turf_decal/trimline/dark/filled/line,
/obj/effect/turf_decal/trimline/dark/filled/mid_joiner,
/obj/effect/turf_decal/trimline/dark/filled/mid_joiner{
	pixel_x = 16
	},
/turf/open/floor/iron/diagonal,
/area/space)
"Vw" = (
/obj/effect/turf_decal/siding/wideplating_new{
	dir = 8
	},
/obj/effect/turf_decal/siding/wideplating_new{
	dir = 4
	},
/obj/machinery/door/airlock/grunge{
	dir = 4
	},
/obj/effect/mapping_helpers/airlock/autoname,
/turf/open/floor/iron/smooth_large,
/area/space)
"Wt" = (
/obj/structure/table/wood,
/obj/effect/spawner/random/bureaucracy/paper{
	pixel_y = 8
	},
/obj/effect/spawner/random/bureaucracy/pen{
	pixel_y = 8
	},
/turf/open/floor/wood/parquet,
/area/space)
"Xj" = (
/obj/structure/fluff/fake_vent,
/turf/open/floor/iron/kitchen,
/area/space)
"Xo" = (
/obj/structure/table/wood,
/turf/open/floor/wood/parquet,
/area/space)
"XD" = (
/obj/structure/chair/sofa/corner/brown{
	dir = 1
	},
/turf/open/floor/wood,
/area/space)
"Zm" = (
/obj/effect/planetary_turf_atmos_helper,
/turf/closed/indestructible,
/area/space)

(1,1,1) = {"
bn
bn
bn
bn
me
me
me
me
me
me
me
me
GF
"}
(2,1,1) = {"
bn
Zm
me
me
me
zl
zo
aU
IJ
uZ
XD
me
me
"}
(3,1,1) = {"
me
me
gj
TQ
me
fV
Xj
yM
wN
xb
zE
BT
me
"}
(4,1,1) = {"
me
qK
bb
Ry
vX
IJ
IJ
IJ
IJ
me
IJ
me
me
"}
(5,1,1) = {"
me
me
mM
RV
me
me
Vw
me
is
is
is
aN
hi
"}
(6,1,1) = {"
bn
me
me
me
me
sK
HZ
me
lx
is
Ee
aN
yd
"}
(7,1,1) = {"
bn
bn
bn
me
vA
HZ
HZ
me
me
fv
me
me
wi
"}
(8,1,1) = {"
bn
bn
me
me
Ao
Ao
SD
wA
me
Dr
vm
Mr
Vl
"}
(9,1,1) = {"
bn
bn
me
Hj
gT
ig
Xo
Wt
me
BM
Ml
me
Dv
"}
(10,1,1) = {"
bn
bn
me
FV
Ly
me
me
me
me
po
me
me
Er
"}
(11,1,1) = {"
bn
bn
me
me
me
me
bn
bn
me
Gs
Hw
Gs
fH
"}
