//MAP CONVERTED BY dmm2tgm.py THIS HEADER COMMENT PREVENTS RECONVERSION, DO NOT REMOVE
"aA" = (
/obj/machinery/computer/camera_advanced/base_construction/broadcast{
	dir = 8
	},
/obj/machinery/atmospherics/pipe/smart/manifold4w/supply/hidden/layer4,
/obj/machinery/atmospherics/pipe/smart/manifold4w/scrubbers/hidden/layer2,
/turf/open/floor/iron/dark,
/area/station/service/broadcast_centre)
"aI" = (
/obj/machinery/light/small/directional/north,
/turf/open/floor/iron/dark,
/area/station/service/broadcast_centre)
"aR" = (
/turf/open/floor/iron/dark,
/area/station/service/broadcast_centre)
"bG" = (
/obj/machinery/computer/security/telescreen/broadcast_team,
/obj/structure/table,
/turf/open/floor/iron/dark,
/area/station/service/broadcast_centre)
"di" = (
/obj/machinery/rnd/production/circuit_imprinter,
/obj/machinery/door/firedoor,
/turf/open/floor/plating,
/area/station/service/broadcast_centre)
"eb" = (
/obj/structure/table/wood,
/turf/open/floor/wood/large,
/area/station/service/broadcast_centre)
"eB" = (
/obj/machinery/atmospherics/components/unary/vent_scrubber/on/layer2{
	dir = 1
	},
/turf/open/floor/iron/dark,
/area/station/service/broadcast_centre)
"gx" = (
/turf/closed/wall,
/area/station/service/broadcast_centre)
"hn" = (
/obj/effect/turf_decal/siding/dark{
	dir = 4
	},
/obj/machinery/atmospherics/pipe/smart/manifold4w/supply/hidden/layer4,
/obj/machinery/atmospherics/pipe/smart/manifold4w/scrubbers/hidden/layer2,
/turf/open/floor/iron/dark,
/area/station/service/broadcast_centre)
"iv" = (
/obj/machinery/door/airlock/hatch{
	name = "Maintenance Hatch"
	},
/obj/effect/mapping_helpers/airlock/access/all/service/broadcast_centre,
/turf/open/floor/plating,
/area/station/service/broadcast_centre)
"jh" = (
/turf/open/floor/wood,
/area/station/service/broadcast_centre)
"jL" = (
/obj/structure/chair/office{
	dir = 4
	},
/obj/machinery/atmospherics/pipe/smart/manifold4w/supply/hidden/layer4,
/obj/machinery/atmospherics/pipe/smart/manifold4w/scrubbers/hidden/layer2,
/obj/structure/cable,
/turf/open/floor/iron/dark,
/area/station/service/broadcast_centre)
"kY" = (
/obj/structure/cable,
/obj/machinery/power/apc/auto_name/directional/west,
/turf/open/floor/iron/dark,
/area/station/service/broadcast_centre)
"lP" = (
/obj/effect/turf_decal/bot_white,
/turf/open/floor/wood/large,
/area/station/service/broadcast_centre)
"oR" = (
/obj/machinery/autolathe,
/obj/machinery/door/firedoor,
/turf/open/floor/plating,
/area/station/service/broadcast_centre)
"oW" = (
/obj/structure/chair/sofa/bench/right,
/obj/effect/turf_decal/siding/wood,
/turf/open/floor/iron/dark,
/area/station/service/broadcast_centre)
"pQ" = (
/obj/effect/spawner/structure/window/reinforced,
/turf/open/floor/plating,
/area/station/service/broadcast_centre)
"qv" = (
/obj/effect/turf_decal/siding/wood{
	dir = 8
	},
/obj/effect/turf_decal/siding/wood{
	dir = 4
	},
/obj/machinery/door/airlock,
/obj/effect/mapping_helpers/airlock/autoname,
/turf/open/floor/wood/large,
/area/station/service/broadcast_centre)
"ry" = (
/obj/effect/turf_decal/siding/dark{
	dir = 4
	},
/turf/open/floor/iron/dark,
/area/station/service/broadcast_centre)
"rY" = (
/obj/machinery/computer/security/telescreen/entertainment/directional/south,
/obj/structure/table/wood,
/turf/open/floor/wood/large,
/area/station/service/broadcast_centre)
"sY" = (
/obj/structure/table,
/obj/machinery/cell_charger,
/turf/open/floor/iron/dark,
/area/station/service/broadcast_centre)
"tF" = (
/turf/open/floor/wood/large,
/area/station/service/broadcast_centre)
"vo" = (
/obj/structure/table,
/obj/machinery/button/showtime/broadcast_team,
/obj/item/reagent_containers/cup/glass/waterbottle{
	pixel_y = 12;
	pixel_x = 8
	},
/obj/machinery/atmospherics/pipe/smart/manifold4w/supply/hidden/layer4,
/turf/open/floor/iron/dark,
/area/station/service/broadcast_centre)
"xr" = (
/obj/structure/table,
/obj/item/storage/toolbox/mechanical{
	pixel_y = 10;
	pixel_x = 3
	},
/obj/item/storage/toolbox/mechanical{
	pixel_y = 5;
	pixel_x = 2
	},
/obj/item/multitool{
	pixel_x = -4
	},
/obj/item/multitool{
	pixel_x = 2
	},
/turf/open/floor/iron/dark,
/area/station/service/broadcast_centre)
"yd" = (
/obj/structure/chair{
	dir = 8
	},
/turf/open/floor/iron/dark,
/area/station/service/broadcast_centre)
"yf" = (
/obj/structure/reagent_dispensers/water_cooler,
/turf/open/floor/wood/large,
/area/station/service/broadcast_centre)
"AA" = (
/obj/effect/turf_decal/siding/dark/corner,
/obj/structure/chair{
	dir = 8
	},
/turf/open/floor/iron/dark,
/area/station/service/broadcast_centre)
"AM" = (
/obj/effect/turf_decal/siding/wood{
	dir = 8
	},
/obj/effect/turf_decal/siding/wood{
	dir = 4
	},
/obj/machinery/door/airlock,
/obj/effect/mapping_helpers/airlock/access/all/service/broadcast_centre,
/obj/effect/mapping_helpers/airlock/autoname,
/turf/open/floor/wood/large,
/area/station/service/broadcast_centre)
"Fd" = (
/obj/effect/turf_decal/siding/dark/corner,
/turf/closed/wall,
/area/station/service/broadcast_centre)
"FW" = (
/obj/machinery/door/airlock,
/obj/effect/mapping_helpers/airlock/access/all/service/broadcast_centre,
/obj/effect/mapping_helpers/airlock/autoname,
/obj/machinery/atmospherics/pipe/smart/manifold4w/supply/hidden/layer4,
/obj/machinery/atmospherics/pipe/smart/manifold4w/scrubbers/hidden/layer2,
/obj/structure/cable,
/turf/open/floor/iron/dark,
/area/station/service/broadcast_centre)
"Ge" = (
/obj/machinery/light/directional/south,
/obj/structure/table/wood,
/obj/item/paper_bin{
	pixel_y = 4
	},
/obj/item/pen,
/turf/open/floor/wood/large,
/area/station/service/broadcast_centre)
"Gy" = (
/obj/machinery/power/floodlight,
/obj/structure/cable,
/turf/open/floor/catwalk_floor/iron_dark,
/area/station/service/broadcast_centre)
"Iq" = (
/obj/structure/cable,
/turf/open/floor/catwalk_floor/iron_dark,
/area/station/service/broadcast_centre)
"Nn" = (
/obj/machinery/atmospherics/pipe/smart/manifold4w/supply/hidden/layer4,
/turf/open/floor/iron/dark,
/area/station/service/broadcast_centre)
"Nz" = (
/turf/open/floor/iron,
/area/station/service/broadcast_centre)
"Oo" = (
/obj/item/kirbyplants/fullysynthetic,
/turf/open/floor/wood/large,
/area/station/service/broadcast_centre)
"QX" = (
/obj/effect/turf_decal/siding/dark{
	dir = 4
	},
/obj/structure/cable,
/obj/machinery/atmospherics/pipe/smart/manifold4w/supply/hidden/layer4,
/obj/machinery/atmospherics/pipe/smart/manifold4w/scrubbers/hidden/layer2,
/turf/open/floor/iron/dark,
/area/station/service/broadcast_centre)
"SM" = (
/obj/machinery/door/airlock/hatch{
	name = "Maintenance Hatch"
	},
/obj/effect/mapping_helpers/airlock/access/all/service/broadcast_centre,
/obj/effect/turf_decal/stripes/line{
	dir = 1
	},
/obj/structure/cable,
/obj/machinery/atmospherics/pipe/smart/manifold4w/supply/hidden/layer4,
/obj/machinery/atmospherics/pipe/smart/manifold4w/scrubbers/hidden/layer2,
/turf/open/floor/plating,
/area/station/service/broadcast_centre)
"Ty" = (
/obj/machinery/atmospherics/components/unary/vent_pump/on/layer4,
/turf/open/floor/iron/dark,
/area/station/service/broadcast_centre)
"VR" = (
/obj/machinery/camera/broadcast/directional/east{
	view_range = 5
	},
/turf/open/floor/iron,
/area/station/service/broadcast_centre)
"Wy" = (
/turf/template_noop,
/area/template_noop)
"Xx" = (
/obj/machinery/atmospherics/pipe/smart/manifold4w/supply/hidden/layer4,
/obj/machinery/atmospherics/pipe/smart/manifold4w/scrubbers/hidden/layer2,
/obj/structure/cable,
/turf/open/floor/iron/dark,
/area/station/service/broadcast_centre)
"Xz" = (
/obj/structure/chair/sofa/bench/left,
/obj/effect/turf_decal/siding/wood{
	dir = 6
	},
/turf/open/floor/iron/dark,
/area/station/service/broadcast_centre)
"XF" = (
/obj/structure/table,
/obj/item/airlock_painter/decal/tile{
	pixel_y = 6
	},
/obj/item/airlock_painter/decal{
	pixel_y = 1
	},
/turf/open/floor/iron/dark,
/area/station/service/broadcast_centre)

(1,1,1) = {"
gx
gx
gx
gx
gx
gx
gx
gx
Wy
Wy
Wy
Wy
Wy
Wy
"}
(2,1,1) = {"
gx
aR
aR
aR
aR
aR
aR
gx
iv
gx
gx
gx
gx
gx
"}
(3,1,1) = {"
gx
aR
aR
aR
aR
aR
aR
aR
aR
aR
aR
aR
aR
gx
"}
(4,1,1) = {"
gx
aR
aR
aR
aR
aR
aR
aR
aR
aR
aR
aR
aR
gx
"}
(5,1,1) = {"
gx
gx
aR
aR
aR
aR
aR
aR
aR
aR
aR
aR
aR
gx
"}
(6,1,1) = {"
Wy
gx
aR
aR
aR
aR
aR
aR
aR
Xx
aR
aR
aR
gx
"}
(7,1,1) = {"
Wy
gx
gx
gx
aR
aR
aR
aR
aR
Xx
aR
aR
gx
gx
"}
(8,1,1) = {"
Wy
Wy
Wy
gx
gx
gx
oR
di
gx
FW
gx
gx
gx
Wy
"}
(9,1,1) = {"
Wy
Wy
Wy
gx
xr
XF
aR
aR
kY
Xx
eB
aR
gx
Wy
"}
(10,1,1) = {"
Wy
Wy
Wy
gx
sY
aR
aR
aR
bG
jL
Iq
aR
gx
Wy
"}
(11,1,1) = {"
Wy
Wy
Wy
gx
aI
Ty
Nn
Nn
vo
aA
Gy
aR
gx
Wy
"}
(12,1,1) = {"
Wy
Wy
Wy
gx
aR
yd
AA
ry
ry
hn
QX
QX
SM
Wy
"}
(13,1,1) = {"
Wy
Wy
gx
gx
AM
gx
Fd
Nz
Nz
Nz
Nz
Nz
gx
Wy
"}
(14,1,1) = {"
Wy
Wy
gx
oW
jh
Oo
gx
Nz
Nz
Nz
Nz
Nz
gx
Wy
"}
(15,1,1) = {"
Wy
Wy
gx
Xz
jh
Ge
gx
Nz
Nz
Nz
Nz
Nz
gx
Wy
"}
(16,1,1) = {"
gx
gx
gx
lP
jh
rY
gx
Nz
Nz
Nz
Nz
Nz
gx
Wy
"}
(17,1,1) = {"
gx
yf
jh
tF
jh
eb
gx
Nz
Nz
VR
Nz
Nz
gx
Wy
"}
(18,1,1) = {"
gx
gx
qv
pQ
qv
gx
gx
gx
gx
gx
gx
gx
gx
Wy
"}
