//MAP CONVERTED BY dmm2tgm.py THIS HEADER COMMENT PREVENTS RECONVERSION, DO NOT REMOVE
"ae" = (
/obj/machinery/light/built/directional/north,
/obj/item/light/tube/broken,
/obj/structure/cable,
/obj/machinery/atmospherics/pipe/smart/manifold4w/supply/hidden/layer4,
/obj/machinery/atmospherics/pipe/smart/manifold4w/scrubbers/hidden/layer2,
/turf/open/floor/iron/white,
/area/station/medical/abandoned)
"al" = (
/obj/effect/turf_decal/trimline/blue/filled/corner,
/obj/effect/decal/cleanable/dirt/dust,
/turf/open/floor/iron/white,
/area/station/medical/abandoned)
"aA" = (
/obj/structure/cable,
/obj/machinery/atmospherics/pipe/smart/manifold4w/supply/hidden/layer4,
/obj/machinery/atmospherics/pipe/smart/manifold4w/scrubbers/hidden/layer2,
/obj/effect/decal/cleanable/dirt/dust,
/turf/open/floor/catwalk_floor/iron_white,
/area/station/medical/abandoned)
"aE" = (
/obj/effect/turf_decal/tile/blue/half{
	dir = 4
	},
/obj/item/stack/cable_coil/cut,
/obj/item/electronics/airlock,
/obj/structure/cable,
/obj/machinery/atmospherics/pipe/smart/manifold4w/supply/hidden/layer4,
/obj/machinery/atmospherics/pipe/smart/manifold4w/scrubbers/hidden/layer2,
/turf/open/floor/iron/white/textured_edge{
	dir = 4
	},
/area/station/medical/abandoned)
"aI" = (
/obj/machinery/door/firedoor,
/obj/machinery/vending/boozeomat/all_access,
/turf/open/floor/plating,
/area/station/medical/abandoned)
"aP" = (
/obj/structure/closet/crate/trashcart/filled,
/obj/structure/sign/poster/official/random/directional/south,
/turf/open/floor/plating,
/area/station/medical/abandoned)
"aR" = (
/obj/effect/spawner/random/structure/table_or_rack,
/obj/item/reagent_containers/pill/maintenance,
/turf/open/floor/iron/white,
/area/station/medical/abandoned)
"bG" = (
/obj/structure/cable,
/obj/machinery/atmospherics/pipe/smart/manifold4w/supply/hidden/layer4,
/obj/machinery/atmospherics/pipe/smart/manifold4w/scrubbers/hidden/layer2,
/obj/effect/turf_decal/trimline/blue/filled/warning{
	dir = 1
	},
/obj/effect/turf_decal/trimline/yellow/warning{
	dir = 1
	},
/turf/open/floor/iron/white,
/area/station/medical/abandoned)
"cm" = (
/obj/effect/turf_decal/tile/green/opposingcorners{
	dir = 8
	},
/obj/effect/turf_decal/box,
/obj/machinery/holopad,
/turf/open/floor/iron/checker,
/area/station/commons/vacant_room/commissary)
"cv" = (
/obj/item/weldingtool/mini,
/turf/open/floor/plating,
/area/station/medical/abandoned)
"cy" = (
/obj/effect/decal/cleanable/dirt/dust,
/obj/machinery/disposal/bin,
/obj/structure/disposalpipe/trunk{
	dir = 4
	},
/turf/open/floor/plating,
/area/station/medical/abandoned)
"di" = (
/obj/effect/decal/cleanable/cobweb,
/obj/effect/spawner/random/structure/closet_maintenance,
/obj/effect/decal/cleanable/dirt/dust,
/turf/open/floor/plating,
/area/station/medical/abandoned)
"dk" = (
/obj/structure/frame/computer{
	dir = 4
	},
/turf/open/floor/plating,
/area/station/medical/abandoned)
"dl" = (
/obj/effect/decal/cleanable/dirt/dust,
/obj/effect/decal/cleanable/dirt/dust,
/obj/structure/grille,
/turf/open/floor/plating,
/area/station/medical/abandoned)
"dp" = (
/obj/effect/turf_decal/stripes/line{
	dir = 10
	},
/obj/effect/decal/cleanable/dirt/dust,
/turf/open/floor/plating,
/area/station/medical/abandoned)
"dt" = (
/obj/structure/cable,
/obj/machinery/atmospherics/pipe/smart/manifold4w/supply/hidden/layer4,
/obj/machinery/atmospherics/pipe/smart/manifold4w/scrubbers/hidden/layer2,
/turf/open/floor/iron/white,
/area/station/medical/abandoned)
"dH" = (
/turf/closed/wall,
/area/station/maintenance/floor3/port)
"eb" = (
/obj/effect/spawner/random/trash/hobo_squat,
/obj/effect/decal/cleanable/dirt/dust,
/turf/open/floor/plating,
/area/station/medical/abandoned)
"eB" = (
/obj/machinery/atmospherics/pipe/smart/manifold4w/supply/hidden/layer4,
/obj/effect/decal/cleanable/dirt/dust,
/obj/structure/cable,
/turf/open/floor/plating,
/area/station/medical/abandoned)
"gx" = (
/obj/machinery/door/firedoor,
/turf/open/floor/iron/white,
/area/station/medical/abandoned)
"gT" = (
/turf/open/floor/light/colour_cycle/dancefloor_a,
/area/station/medical/abandoned)
"gV" = (
/obj/effect/turf_decal/tile/blue/full,
/obj/machinery/power/floodlight,
/obj/structure/cable,
/obj/effect/decal/cleanable/dirt/dust,
/obj/machinery/atmospherics/pipe/smart/manifold4w/supply/hidden/layer4,
/obj/machinery/atmospherics/pipe/smart/manifold4w/scrubbers/hidden/layer2,
/turf/open/floor/iron/white/textured_large,
/area/station/medical/abandoned)
"hj" = (
/obj/item/stack/sheet/iron,
/obj/structure/cable,
/obj/effect/decal/cleanable/dirt/dust,
/turf/open/floor/plating,
/area/station/medical/abandoned)
"hn" = (
/obj/structure/chair/stool/directional/north,
/obj/structure/cable,
/obj/effect/turf_decal/tile/blue/half{
	dir = 4
	},
/obj/machinery/atmospherics/pipe/smart/manifold4w/supply/hidden/layer4,
/obj/machinery/atmospherics/pipe/smart/manifold4w/scrubbers/hidden/layer2,
/turf/open/floor/iron/white/smooth_edge{
	dir = 4
	},
/area/station/medical/abandoned)
"ik" = (
/obj/structure/bed,
/turf/open/floor/iron/white,
/area/station/medical/abandoned)
"iv" = (
/obj/effect/mapping_helpers/airlock/access/any/engineering/maintenance,
/obj/structure/cable,
/obj/machinery/atmospherics/pipe/smart/manifold4w/supply/hidden/layer4,
/obj/machinery/atmospherics/pipe/smart/manifold4w/scrubbers/hidden/layer2,
/obj/machinery/door/airlock/hatch{
	name = "Maintenance Hatch"
	},
/obj/effect/mapping_helpers/airlock/unres{
	dir = 8
	},
/turf/open/floor/plating,
/area/station/maintenance/floor3/port)
"jh" = (
/obj/effect/decal/cleanable/dirt/dust,
/obj/item/stack/cable_coil/cut,
/turf/open/floor/plating,
/area/station/medical/abandoned)
"jL" = (
/obj/effect/turf_decal/tile/blue/half{
	dir = 8
	},
/obj/structure/tank_holder/emergency_oxygen,
/obj/structure/cable,
/obj/machinery/atmospherics/pipe/smart/manifold4w/supply/hidden/layer4,
/obj/machinery/atmospherics/pipe/smart/manifold4w/scrubbers/hidden/layer2,
/obj/effect/decal/cleanable/dirt/dust,
/turf/open/floor/iron/white/smooth_edge{
	dir = 8
	},
/area/station/medical/abandoned)
"kY" = (
/obj/effect/decal/cleanable/dirt/dust,
/turf/open/floor/iron/white,
/area/station/medical/abandoned)
"lP" = (
/obj/effect/decal/cleanable/ash,
/turf/open/floor/plating,
/area/station/medical/abandoned)
"mI" = (
/obj/effect/turf_decal/trimline/green/filled/line{
	dir = 8
	},
/turf/open/floor/iron,
/area/station/commons/vacant_room/commissary)
"nj" = (
/obj/effect/spawner/random/structure/chair_maintenance{
	dir = 8
	},
/obj/effect/decal/cleanable/dirt/dust,
/obj/structure/sign/poster/contraband/random/directional/east,
/turf/open/floor/plating,
/area/station/medical/abandoned)
"nR" = (
/obj/machinery/atmospherics/pipe/smart/manifold4w/supply/hidden/layer4,
/obj/effect/decal/cleanable/dirt/dust,
/turf/open/floor/plating,
/area/station/medical/abandoned)
"nS" = (
/obj/item/stack/tile/iron/white,
/obj/effect/decal/cleanable/dirt/dust,
/turf/open/floor/plating,
/area/station/medical/abandoned)
"oj" = (
/obj/effect/spawner/random/vending/colavend,
/obj/effect/turf_decal/tile/green/opposingcorners{
	dir = 8
	},
/turf/open/floor/iron/checker,
/area/station/commons/vacant_room/commissary)
"ol" = (
/obj/machinery/door/firedoor,
/obj/effect/decal/cleanable/dirt/dust,
/turf/open/floor/iron/white,
/area/station/medical/abandoned)
"oQ" = (
/turf/closed/wall,
/area/station/commons/vacant_room/commissary)
"oR" = (
/turf/closed/wall,
/area/station/medical/abandoned)
"oW" = (
/obj/effect/spawner/random/structure/crate,
/obj/effect/decal/cleanable/dirt/dust,
/turf/open/floor/plating,
/area/station/medical/abandoned)
"pQ" = (
/turf/open/floor/plating,
/area/station/medical/abandoned)
"qv" = (
/obj/effect/spawner/random/trash/graffiti,
/turf/open/floor/iron/white,
/area/station/medical/abandoned)
"ry" = (
/obj/machinery/chem_master,
/obj/structure/cable,
/obj/machinery/atmospherics/pipe/smart/manifold4w/supply/hidden/layer4,
/obj/machinery/atmospherics/pipe/smart/manifold4w/scrubbers/hidden/layer2,
/obj/effect/decal/cleanable/dirt/dust,
/turf/open/floor/iron/white,
/area/station/medical/abandoned)
"rY" = (
/obj/machinery/atmospherics/components/unary/vent_pump/on/layer4{
	dir = 8
	},
/obj/effect/decal/cleanable/dirt/dust,
/turf/open/floor/plating,
/area/station/medical/abandoned)
"sY" = (
/obj/structure/table_frame,
/obj/effect/turf_decal/trimline/blue/filled/corner{
	dir = 4
	},
/turf/open/floor/iron/white,
/area/station/medical/abandoned)
"tF" = (
/obj/effect/spawner/random/trash/grime,
/obj/effect/decal/cleanable/dirt/dust,
/turf/open/floor/plating,
/area/station/medical/abandoned)
"tJ" = (
/obj/item/stack/tile/iron/white,
/turf/open/floor/plating,
/area/station/medical/abandoned)
"ub" = (
/obj/structure/rack,
/obj/effect/decal/cleanable/cobweb/cobweb2,
/turf/open/floor/plating,
/area/station/medical/abandoned)
"up" = (
/obj/structure/cable,
/obj/machinery/atmospherics/pipe/smart/manifold4w/scrubbers/hidden/layer2,
/obj/item/stack/cable_coil/cut,
/obj/effect/decal/cleanable/dirt/dust,
/turf/open/floor/plating,
/area/station/medical/abandoned)
"uG" = (
/obj/item/stack/tile/iron/white,
/obj/structure/cable,
/obj/machinery/atmospherics/pipe/smart/manifold4w/supply/hidden/layer4,
/obj/machinery/atmospherics/pipe/smart/manifold4w/scrubbers/hidden/layer2,
/obj/effect/decal/cleanable/dirt/dust,
/obj/structure/sign/poster/contraband/random/directional/north,
/turf/open/floor/plating,
/area/station/medical/abandoned)
"vo" = (
/obj/structure/table,
/obj/item/clothing/mask/gas,
/obj/effect/turf_decal/tile/blue/half{
	dir = 1
	},
/turf/open/floor/iron/white/smooth_edge{
	dir = 1
	},
/area/station/medical/abandoned)
"vM" = (
/obj/effect/turf_decal/tile/blue/half,
/obj/effect/decal/cleanable/dirt/dust,
/turf/open/floor/iron/white/textured_edge,
/area/station/medical/abandoned)
"vQ" = (
/obj/machinery/atmospherics/components/unary/vent_scrubber/on/layer2{
	dir = 4
	},
/obj/structure/cable,
/obj/effect/decal/cleanable/dirt/dust,
/turf/open/floor/plating,
/area/station/medical/abandoned)
"wo" = (
/obj/effect/turf_decal/trimline/green/filled/line{
	dir = 8
	},
/obj/item/radio/intercom/directional/west,
/turf/open/floor/iron,
/area/station/commons/vacant_room/commissary)
"xr" = (
/obj/effect/turf_decal/trimline/blue/filled/corner{
	dir = 1
	},
/obj/effect/decal/cleanable/dirt/dust,
/obj/machinery/power/apc/auto_name/directional/north,
/obj/structure/cable,
/turf/open/floor/iron/white,
/area/station/medical/abandoned)
"xZ" = (
/turf/open/floor/iron/white,
/area/station/medical/abandoned)
"yc" = (
/obj/structure/disposalpipe/segment{
	dir = 4
	},
/turf/open/floor/plating,
/area/station/medical/abandoned)
"yd" = (
/obj/structure/cable,
/obj/machinery/atmospherics/pipe/smart/manifold4w/supply/hidden/layer4,
/obj/machinery/atmospherics/pipe/smart/manifold4w/scrubbers/hidden/layer2,
/obj/effect/decal/cleanable/dirt/dust,
/turf/open/floor/plating,
/area/station/medical/abandoned)
"yf" = (
/obj/effect/decal/cleanable/dirt/dust,
/obj/effect/decal/cleanable/dirt/dust,
/obj/structure/grille/broken,
/turf/open/floor/plating,
/area/station/medical/abandoned)
"zG" = (
/obj/effect/spawner/structure/window/reinforced,
/turf/open/floor/plating,
/area/station/medical/abandoned)
"AA" = (
/obj/effect/mapping_helpers/airlock/access/any/engineering/maintenance,
/obj/structure/cable,
/obj/machinery/atmospherics/pipe/smart/manifold4w/supply/hidden/layer4,
/obj/machinery/atmospherics/pipe/smart/manifold4w/scrubbers/hidden/layer2,
/obj/effect/decal/cleanable/dirt/dust,
/obj/machinery/door/airlock/medical/glass{
	name = "Medical Front Desk"
	},
/obj/effect/mapping_helpers/airlock/unres{
	dir = 1
	},
/turf/open/floor/plating,
/area/station/medical/abandoned)
"AM" = (
/obj/effect/decal/cleanable/dirt/dust,
/turf/open/floor/plating,
/area/station/medical/abandoned)
"Cw" = (
/obj/item/instrument/banjo,
/turf/open/floor/plating,
/area/station/medical/abandoned)
"DQ" = (
/obj/effect/mapping_helpers/airlock/access/any/engineering/maintenance,
/obj/structure/cable,
/obj/machinery/atmospherics/pipe/smart/manifold4w/supply/hidden/layer4,
/obj/machinery/atmospherics/pipe/smart/manifold4w/scrubbers/hidden/layer2,
/obj/machinery/door/airlock/virology{
	name = "Virology"
	},
/obj/effect/mapping_helpers/airlock/unres{
	dir = 8
	},
/turf/open/floor/plating,
/area/station/medical/abandoned)
"Eb" = (
/obj/effect/turf_decal/trimline/blue/filled/corner{
	dir = 4
	},
/obj/effect/decal/cleanable/dirt/dust,
/obj/effect/turf_decal/trimline/blue/filled/corner{
	dir = 1
	},
/obj/effect/turf_decal/trimline/yellow/corner{
	dir = 1
	},
/turf/open/floor/iron/white,
/area/station/medical/abandoned)
"EQ" = (
/obj/effect/decal/cleanable/dirt/dust,
/turf/open/floor/light/colour_cycle/dancefloor_b,
/area/station/medical/abandoned)
"Fd" = (
/obj/effect/turf_decal/trimline/green/filled/line{
	dir = 8
	},
/obj/structure/sign/poster/official/random/directional/west,
/turf/open/floor/iron,
/area/station/commons/vacant_room/commissary)
"FW" = (
/obj/machinery/door/firedoor,
/obj/structure/cable,
/obj/machinery/atmospherics/pipe/smart/manifold4w/supply/hidden/layer4,
/obj/machinery/atmospherics/pipe/smart/manifold4w/scrubbers/hidden/layer2,
/obj/effect/decal/cleanable/dirt/dust,
/turf/open/floor/iron/white,
/area/station/medical/abandoned)
"Ge" = (
/obj/machinery/atmospherics/pipe/smart/manifold4w/supply/hidden/layer4,
/turf/open/floor/plating,
/area/station/medical/abandoned)
"Gf" = (
/obj/structure/door_assembly/door_assembly_med,
/obj/machinery/door/firedoor,
/turf/open/floor/iron/white,
/area/station/medical/abandoned)
"Gy" = (
/obj/machinery/space_heater/improvised_chem_heater,
/obj/effect/turf_decal/tile/blue/half,
/obj/effect/decal/cleanable/dirt/dust,
/turf/open/floor/iron/white/smooth_edge,
/area/station/medical/abandoned)
"Hr" = (
/obj/structure/falsewall,
/turf/open/floor/plating,
/area/station/medical/abandoned)
"HB" = (
/obj/structure/cable,
/obj/machinery/atmospherics/pipe/smart/manifold4w/supply/hidden/layer4,
/obj/machinery/atmospherics/pipe/smart/manifold4w/scrubbers/hidden/layer2,
/turf/open/floor/plating,
/area/station/medical/abandoned)
"HK" = (
/obj/structure/disposalpipe/trunk{
	dir = 8
	},
/obj/machinery/disposal/bin,
/turf/open/floor/plating,
/area/station/medical/abandoned)
"Ik" = (
/obj/machinery/atmospherics/pipe/smart/manifold4w/supply/hidden/layer4,
/obj/machinery/atmospherics/pipe/smart/manifold4w/scrubbers/hidden/layer2,
/obj/effect/decal/cleanable/dirt/dust,
/obj/structure/cable,
/turf/open/floor/iron/white,
/area/station/medical/abandoned)
"Iq" = (
/turf/open/floor/light/colour_cycle/dancefloor_b,
/area/station/medical/abandoned)
"Ix" = (
/obj/machinery/medical_kiosk,
/turf/open/floor/plating,
/area/station/medical/abandoned)
"Jn" = (
/obj/effect/spawner/random/structure/table,
/obj/effect/decal/cleanable/dirt/dust,
/turf/open/floor/iron/white,
/area/station/medical/abandoned)
"JF" = (
/obj/machinery/airalarm/directional/south,
/obj/effect/spawner/random/trash/hobo_squat,
/turf/open/floor/iron/white,
/area/station/medical/abandoned)
"MP" = (
/turf/closed/wall,
/area/station/commons/dorms/apartment1)
"Nn" = (
/obj/machinery/firealarm/directional/north,
/obj/effect/decal/cleanable/dirt/dust,
/obj/effect/turf_decal/trimline/blue/filled/corner{
	dir = 4
	},
/obj/effect/turf_decal/trimline/yellow/corner{
	dir = 4
	},
/turf/open/floor/iron/white,
/area/station/medical/abandoned)
"Nz" = (
/obj/structure/rack,
/obj/effect/decal/cleanable/dirt/dust,
/turf/open/floor/iron/white,
/area/station/medical/abandoned)
"NY" = (
/obj/effect/decal/cleanable/dirt/dust,
/obj/effect/decal/cleanable/dirt/dust,
/turf/open/floor/plating,
/area/station/medical/abandoned)
"Od" = (
/obj/effect/turf_decal/stripes/line,
/turf/open/floor/plating,
/area/station/medical/abandoned)
"Oo" = (
/obj/structure/bonfire,
/obj/structure/cable,
/obj/machinery/light/broken/directional/south,
/obj/machinery/atmospherics/pipe/smart/manifold4w/supply/hidden/layer4,
/turf/open/floor/plating,
/area/station/medical/abandoned)
"Pg" = (
/obj/effect/spawner/random/trash/mess,
/obj/effect/spawner/random/trash/grime,
/turf/open/floor/light/colour_cycle/dancefloor_a,
/area/station/medical/abandoned)
"QL" = (
/obj/structure/cable,
/obj/machinery/atmospherics/pipe/smart/manifold4w/supply/hidden/layer4,
/obj/machinery/atmospherics/pipe/smart/manifold4w/scrubbers/hidden/layer2,
/turf/open/floor/light/colour_cycle/dancefloor_b,
/area/station/medical/abandoned)
"QX" = (
/obj/structure/table,
/obj/machinery/atmospherics/pipe/smart/manifold4w/supply/hidden/layer4,
/obj/machinery/atmospherics/pipe/smart/manifold4w/scrubbers/hidden/layer2,
/obj/effect/decal/cleanable/dirt/dust,
/obj/structure/cable,
/turf/open/floor/iron/white,
/area/station/medical/abandoned)
"Re" = (
/obj/effect/decal/cleanable/ash/large,
/obj/machinery/atmospherics/components/unary/vent_pump/on/layer4,
/turf/open/floor/plating,
/area/station/medical/abandoned)
"Rw" = (
/obj/item/stack/sheet/iron/five,
/obj/effect/decal/cleanable/dirt/dust,
/turf/open/floor/iron/white,
/area/station/medical/abandoned)
"RU" = (
/obj/effect/decal/cleanable/ash,
/obj/structure/disposalpipe/broken{
	dir = 4
	},
/turf/open/floor/plating,
/area/station/medical/abandoned)
"SA" = (
/obj/effect/spawner/random/trash/graffiti{
	pixel_y = 32
	},
/obj/effect/decal/cleanable/dirt/dust,
/turf/open/floor/iron/white,
/area/station/medical/abandoned)
"SM" = (
/obj/effect/mapping_helpers/airlock/access/any/engineering/maintenance,
/obj/machinery/atmospherics/pipe/smart/manifold4w/supply/hidden/layer4,
/obj/machinery/atmospherics/pipe/smart/manifold4w/scrubbers/hidden/layer2,
/obj/structure/cable,
/obj/machinery/door/airlock/hatch{
	name = "Maintenance Hatch"
	},
/obj/effect/mapping_helpers/airlock/abandoned,
/obj/effect/mapping_helpers/airlock/unres{
	dir = 1
	},
/turf/open/floor/plating,
/area/station/maintenance/floor3/port)
"Ty" = (
/obj/machinery/door/firedoor,
/obj/structure/cable,
/obj/machinery/atmospherics/pipe/smart/manifold4w/supply/hidden/layer4,
/obj/machinery/atmospherics/pipe/smart/manifold4w/scrubbers/hidden/layer2,
/turf/open/floor/plating,
/area/station/medical/abandoned)
"VR" = (
/obj/structure/cable,
/obj/effect/decal/cleanable/dirt/dust,
/obj/machinery/atmospherics/pipe/smart/manifold4w/supply/hidden/layer4,
/obj/machinery/atmospherics/pipe/smart/manifold4w/scrubbers/hidden/layer2,
/turf/open/floor/plating,
/area/station/medical/abandoned)
"Wm" = (
/obj/effect/decal/cleanable/dirt/dust,
/obj/machinery/light/broken/directional/south,
/turf/open/floor/plating,
/area/station/medical/abandoned)
"Wy" = (
/turf/open/space/basic,
/area/space)
"Xx" = (
/obj/structure/cable,
/obj/machinery/atmospherics/pipe/smart/manifold4w/supply/hidden/layer4,
/obj/machinery/atmospherics/pipe/smart/manifold4w/scrubbers/hidden/layer2,
/obj/effect/decal/cleanable/dirt/dust,
/turf/open/floor/light/colour_cycle/dancefloor_a,
/area/station/medical/abandoned)
"Xz" = (
/obj/effect/spawner/random/trash/moisture_trap,
/turf/open/floor/plating,
/area/station/medical/abandoned)
"XF" = (
/obj/structure/cable,
/obj/machinery/atmospherics/pipe/smart/manifold4w/supply/hidden/layer4,
/obj/machinery/atmospherics/pipe/smart/manifold4w/scrubbers/hidden/layer2,
/obj/effect/decal/cleanable/dirt/dust,
/turf/open/floor/iron/white,
/area/station/medical/abandoned)
"XG" = (
/obj/effect/decal/cleanable/dirt/dust,
/obj/effect/spawner/random/trash/graffiti,
/turf/open/floor/iron/white,
/area/station/medical/abandoned)
"XK" = (
/obj/effect/spawner/structure/window/reinforced,
/obj/structure/cable,
/obj/machinery/atmospherics/pipe/smart/manifold4w/supply/hidden/layer4,
/obj/machinery/atmospherics/pipe/smart/manifold4w/scrubbers/hidden/layer2,
/turf/open/floor/plating,
/area/station/medical/abandoned)
"XM" = (
/obj/effect/turf_decal/trimline/green/filled/line{
	dir = 8
	},
/obj/machinery/camera/autoname/directional/west,
/turf/open/floor/iron,
/area/station/commons/vacant_room/commissary)
"YI" = (
/obj/effect/spawner/random/trash/graffiti{
	pixel_y = -32
	},
/obj/structure/disposalpipe/broken{
	dir = 8
	},
/obj/effect/decal/cleanable/dirt/dust,
/turf/open/floor/plating,
/area/station/medical/abandoned)
"YP" = (
/obj/effect/spawner/random/structure/chair_maintenance{
	dir = 4
	},
/turf/open/floor/iron/white,
/area/station/medical/abandoned)
"YW" = (
/obj/effect/turf_decal/trimline/green/filled/line{
	dir = 10
	},
/obj/effect/spawner/random/vending/snackvend,
/turf/open/floor/iron,
/area/station/commons/vacant_room/commissary)
"Zx" = (
/turf/closed/wall,
/area/station/hallway/floor3/fore)
"ZA" = (
/obj/effect/turf_decal/trimline/blue/end{
	dir = 4
	},
/obj/effect/decal/cleanable/dirt/dust,
/obj/machinery/shower/directional/east,
/turf/open/floor/iron/white,
/area/station/medical/abandoned)
"ZD" = (
/obj/item/storage/pill_bottle,
/obj/effect/spawner/random/trash/graffiti{
	pixel_x = -32
	},
/obj/effect/decal/cleanable/dirt/dust,
/turf/open/floor/light/colour_cycle/dancefloor_a,
/area/station/medical/abandoned)

(1,1,1) = {"
Wy
Zx
oR
oR
oR
oR
oR
oR
dH
Wy
Wy
Wy
Wy
Wy
Wy
"}
(2,1,1) = {"
Wy
Zx
AM
AM
pQ
pQ
lP
AM
dH
iv
dH
dH
dH
dH
dH
"}
(3,1,1) = {"
Wy
Zx
AM
AM
dk
hj
vQ
NY
oR
HB
oR
di
YP
xZ
dH
"}
(4,1,1) = {"
Wy
Zx
pQ
RU
AM
pQ
up
AM
oR
uG
ZD
Iq
gT
kY
dH
"}
(5,1,1) = {"
Wy
Zx
oR
yc
Re
nR
HB
oR
oR
ae
QL
Pg
EQ
Jn
dH
"}
(6,1,1) = {"
Wy
Wy
oR
HK
oR
dp
HB
oR
ZA
xZ
Xx
EQ
gT
aR
dH
"}
(7,1,1) = {"
Wy
Wy
MP
MP
MP
Od
HB
oR
ik
kY
dt
kY
JF
dH
dH
"}
(8,1,1) = {"
Wy
Wy
Wy
Wy
MP
oR
DQ
oR
oR
gx
FW
gx
oR
dH
Wy
"}
(9,1,1) = {"
Wy
Wy
Wy
Wy
MP
xr
XF
kY
kY
kY
dt
AM
cy
dH
Wy
"}
(10,1,1) = {"
Wy
Wy
Wy
Wy
MP
sY
dt
XG
xZ
kY
jL
kY
YI
dH
Wy
"}
(11,1,1) = {"
Wy
Wy
Wy
Wy
MP
aI
Ty
oR
Nn
vo
aA
Gy
xZ
dH
Wy
"}
(12,1,1) = {"
Wy
Wy
Wy
Wy
MP
cv
yd
AA
bG
ry
hn
QX
Ik
SM
Wy
"}
(13,1,1) = {"
Wy
Wy
Wy
MP
MP
AM
eB
oR
Eb
kY
dt
xZ
al
dH
Wy
"}
(14,1,1) = {"
Wy
Wy
Wy
MP
oW
jh
Oo
oR
oR
Gf
XK
ol
oR
dH
Wy
"}
(15,1,1) = {"
Wy
Wy
Wy
MP
Xz
tF
Ge
oR
SA
nS
aE
Rw
aP
dH
Wy
"}
(16,1,1) = {"
oQ
oR
oR
oR
oR
Cw
rY
zG
Nz
vM
gV
AM
Wm
dH
Wy
"}
(17,1,1) = {"
oj
oR
yf
dl
oR
nj
eb
oR
ub
qv
VR
tJ
Ix
dH
Wy
"}
(18,1,1) = {"
cm
oR
oR
oR
oR
oR
oR
oR
oR
oR
Hr
oR
oR
dH
Wy
"}
(19,1,1) = {"
mI
XM
mI
wo
Fd
mI
YW
Wy
Wy
Wy
Wy
Wy
Wy
Wy
Wy
"}
