//MAP CONVERTED BY dmm2tgm.py THIS HEADER COMMENT PREVENTS RECONVERSION, DO NOT REMOVE
"a" = (
/turf/closed/wall,
/area/station/service/broadcast_centre)
"c" = (
/obj/effect/spawner/structure/window/reinforced/tinted,
/turf/open/floor/plating,
/area/station/service/broadcast_centre)
"e" = (
/turf/template_noop,
/area/template_noop)
"f" = (
/obj/structure/cable,
/turf/open/floor/plating,
/area/station/maintenance/fore)
"g" = (
/obj/structure/sink/directional/east,
/obj/structure/mirror/directional/west,
/obj/machinery/light/small/directional/south,
/turf/open/floor/iron/freezer,
/area/station/service/broadcast_centre)
"k" = (
/obj/structure/window/spawner/directional/west,
/obj/structure/toilet{
	pixel_y = 12
	},
/obj/effect/landmark/start/broadcast_team,
/turf/open/floor/iron/freezer,
/area/station/service/broadcast_centre)
"l" = (
/obj/effect/turf_decal/tile/neutral/fourcorners,
/turf/open/floor/iron,
/area/station/service/broadcast_centre)
"m" = (
/obj/structure/cable,
/obj/machinery/door/airlock/engineering,
/obj/effect/mapping_helpers/airlock/access/all/engineering/aux_base,
/obj/effect/mapping_helpers/airlock/access/all/service/broadcast_centre,
/obj/effect/mapping_helpers/airlock/autoname,
/turf/open/floor/iron,
/area/station/service/broadcast_centre)
"n" = (
/obj/machinery/button/door/directional/south{
	normaldoorcontrol = 1;
	specialfunctions = 4;
	id = "broadcastbathroom";
	name = "Bolt Control"
	},
/turf/open/floor/iron/freezer,
/area/station/service/broadcast_centre)
"o" = (
/obj/machinery/computer/security/telescreen/entertainment/directional/west,
/obj/item/kirbyplants/random,
/obj/effect/turf_decal/tile/neutral/anticorner/contrasted{
	dir = 8
	},
/obj/effect/turf_decal/trimline/dark_green/line{
	dir = 10
	},
/turf/open/floor/iron,
/area/station/service/broadcast_centre)
"p" = (
/obj/structure/cable,
/obj/machinery/power/apc/auto_name/directional/west,
/turf/open/floor/iron,
/area/station/service/broadcast_centre)
"r" = (
/obj/effect/turf_decal/trimline/dark_green/line{
	dir = 4
	},
/obj/structure/cable,
/turf/open/floor/iron,
/area/station/service/broadcast_centre)
"u" = (
/obj/machinery/atmospherics/pipe/smart/manifold4w/supply/hidden/layer4,
/obj/machinery/atmospherics/pipe/smart/manifold4w/scrubbers/hidden/layer2,
/obj/structure/cable,
/obj/machinery/door/airlock/maintenance_hatch,
/obj/effect/mapping_helpers/airlock/access/all/service/broadcast_centre,
/obj/effect/mapping_helpers/airlock/autoname,
/turf/open/floor/iron,
/area/station/maintenance/fore)
"v" = (
/obj/effect/turf_decal/trimline/dark_green/line{
	dir = 8
	},
/turf/open/floor/iron,
/area/station/service/broadcast_centre)
"w" = (
/obj/effect/turf_decal/trimline/dark_green/line{
	dir = 1
	},
/turf/open/floor/iron,
/area/station/service/broadcast_centre)
"x" = (
/obj/effect/turf_decal/tile/neutral/fourcorners,
/obj/structure/cable,
/turf/open/floor/iron,
/area/station/service/broadcast_centre)
"y" = (
/obj/machinery/shower/directional/south,
/obj/structure/curtain,
/obj/structure/drain,
/turf/open/floor/iron/freezer,
/area/station/service/broadcast_centre)
"A" = (
/turf/open/floor/iron,
/area/station/service/broadcast_centre)
"B" = (
/obj/effect/turf_decal/tile/neutral/anticorner/contrasted{
	dir = 4
	},
/obj/effect/turf_decal/trimline/dark_green/line{
	dir = 5
	},
/obj/structure/chair/sofa/bench/right{
	dir = 8
	},
/turf/open/floor/iron,
/area/station/service/broadcast_centre)
"H" = (
/obj/effect/turf_decal/tile/neutral/anticorner/contrasted,
/obj/effect/turf_decal/trimline/dark_green/line{
	dir = 6
	},
/obj/effect/turf_decal/bot_white,
/turf/open/floor/iron,
/area/station/service/broadcast_centre)
"J" = (
/obj/machinery/atmospherics/pipe/smart/manifold4w/supply/hidden/layer4,
/obj/machinery/atmospherics/pipe/smart/manifold4w/scrubbers/hidden/layer2,
/obj/structure/cable,
/turf/open/floor/iron,
/area/station/maintenance/fore)
"M" = (
/obj/effect/turf_decal/trimline/dark_green/line,
/obj/structure/cable,
/turf/open/floor/iron,
/area/station/service/broadcast_centre)
"N" = (
/obj/effect/turf_decal/tile/neutral/anticorner/contrasted{
	dir = 1
	},
/obj/effect/turf_decal/trimline/dark_green/line{
	dir = 9
	},
/obj/machinery/airalarm/directional/north,
/turf/open/floor/iron,
/area/station/service/broadcast_centre)
"P" = (
/turf/closed/wall,
/area/station/maintenance/fore)
"Q" = (
/obj/effect/turf_decal/stripes/line{
	dir = 8
	},
/obj/effect/turf_decal/stripes/line{
	dir = 4
	},
/obj/machinery/door/airlock,
/obj/effect/mapping_helpers/airlock/access/all/service/broadcast_centre,
/obj/effect/mapping_helpers/airlock/autoname,
/turf/open/floor/iron,
/area/station/service/broadcast_centre)
"R" = (
/obj/effect/turf_decal/trimline/dark_green/line{
	dir = 4
	},
/obj/structure/chair/sofa/bench/left{
	dir = 8
	},
/turf/open/floor/iron,
/area/station/service/broadcast_centre)
"S" = (
/obj/machinery/atmospherics/pipe/smart/manifold4w/supply/hidden/layer4,
/obj/machinery/atmospherics/pipe/smart/manifold4w/scrubbers/hidden/layer2,
/turf/open/floor/iron,
/area/station/maintenance/fore)
"T" = (
/obj/machinery/door/airlock,
/obj/effect/mapping_helpers/airlock/access/all/service/broadcast_centre,
/obj/effect/mapping_helpers/airlock/autoname,
/obj/effect/turf_decal/stripes/line{
	dir = 8
	},
/obj/effect/turf_decal/stripes/line{
	dir = 4
	},
/obj/structure/cable,
/turf/open/floor/iron,
/area/station/service/broadcast_centre)
"U" = (
/turf/open/floor/plating,
/area/station/maintenance/fore)
"V" = (
/obj/effect/turf_decal/stripes/line{
	dir = 8
	},
/obj/effect/turf_decal/stripes/line{
	dir = 4
	},
/obj/machinery/door/airlock/silver{
	name = "Bathroom";
	id_tag = "broadcastbathroom"
	},
/turf/open/floor/iron/herringbone,
/area/station/service/broadcast_centre)
"Y" = (
/obj/machinery/atmospherics/pipe/smart/manifold4w/supply/hidden/layer4,
/obj/machinery/atmospherics/pipe/smart/manifold4w/scrubbers/hidden/layer2,
/turf/open/floor/plating,
/area/station/maintenance/fore)
"Z" = (
/obj/structure/cable,
/turf/open/floor/iron,
/area/station/service/broadcast_centre)

(1,1,1) = {"
a
a
a
a
Q
c
Q
a
P
P
P
"}
(2,1,1) = {"
a
y
g
a
N
v
v
o
P
Y
S
"}
(3,1,1) = {"
a
k
n
a
w
l
x
M
u
J
f
"}
(4,1,1) = {"
a
a
V
a
B
R
r
H
P
P
P
"}
(5,1,1) = {"
m
Z
A
a
a
a
T
a
P
U
P
"}
(6,1,1) = {"
a
Z
Z
Z
p
Z
Z
A
P
U
P
"}
(7,1,1) = {"
a
A
A
A
A
A
A
A
P
U
P
"}
(8,1,1) = {"
a
A
A
A
A
A
A
A
P
P
P
"}
(9,1,1) = {"
a
A
A
A
A
A
A
A
A
a
e
"}
(10,1,1) = {"
a
A
A
A
A
A
A
A
A
a
e
"}
(11,1,1) = {"
a
A
A
A
A
A
A
A
A
a
e
"}
(12,1,1) = {"
a
A
A
A
A
A
A
A
A
a
e
"}
(13,1,1) = {"
a
A
A
A
A
A
A
A
A
a
e
"}
(14,1,1) = {"
a
A
A
A
A
A
A
A
A
a
e
"}
(15,1,1) = {"
a
A
A
A
A
A
A
A
A
a
e
"}
(16,1,1) = {"
a
A
A
A
A
A
A
A
A
a
e
"}
(17,1,1) = {"
a
a
a
a
a
a
A
A
A
a
e
"}
(18,1,1) = {"
e
e
e
e
e
a
A
A
A
a
e
"}
(19,1,1) = {"
e
e
e
e
e
a
A
A
A
a
e
"}
(20,1,1) = {"
e
e
e
e
e
a
A
A
A
a
e
"}
(21,1,1) = {"
e
e
e
e
e
a
a
a
a
a
e
"}
