//MAP CONVERTED BY dmm2tgm.py THIS HEADER COMMENT PREVENTS RECONVERSION, DO NOT REMOVE
"a" = (
/obj/effect/turf_decal/stripes/line{
	dir = 10
	},
/obj/machinery/computer/shuttle/interlink{
	dir = 4
	},
/turf/open/floor/iron,
/area/station/hallway/secondary/entry)

(1,1,1) = {"
a
"}
