//MAP CONVERTED BY dmm2tgm.py THIS HEADER COMMENT PREVENTS RECONVERSION, DO NOT REMOVE
"a" = (
/obj/structure/window/reinforced/tram{
	dir = 4
	},
/obj/machinery/power/shuttle_engine/propulsion{
	dir = 8
	},
/obj/effect/turf_decal/stripes/line{
	dir = 8
	},
/obj/effect/turf_decal/stripes/red/line{
	dir = 8
	},
/turf/open/floor/plating,
/area/template_noop)
"b" = (
/obj/effect/turf_decal/stripes/line{
	dir = 1
	},
/obj/machinery/door/airlock/titanium,
/turf/open/floor/mineral/titanium/blue,
/area/template_noop)
"c" = (
/turf/open/floor/mineral/titanium/blue,
/area/template_noop)
"d" = (
/obj/structure/closet/emcloset/anchored,
/obj/effect/turf_decal/bot_red,
/obj/effect/turf_decal/siding/wideplating_new{
	dir = 4
	},
/turf/open/floor/mineral/titanium/tiled,
/area/template_noop)
"e" = (
/obj/effect/spawner/structure/window/reinforced/shuttle,
/turf/open/floor/plating,
/area/template_noop)
"i" = (
/turf/template_noop,
/area/template_noop)
"k" = (
/obj/structure/chair/sofa/bench/left,
/obj/machinery/light/cold/directional/north,
/turf/open/floor/mineral/titanium,
/area/template_noop)
"l" = (
/obj/structure/chair/sofa/bench/left{
	dir = 1
	},
/obj/machinery/light/cold/directional/south,
/turf/open/floor/mineral/titanium,
/area/template_noop)
"m" = (
/obj/effect/turf_decal/stripes/line,
/obj/machinery/door/airlock/titanium,
/turf/open/floor/mineral/titanium/blue,
/area/template_noop)
"n" = (
/obj/structure/closet/emcloset/anchored,
/obj/effect/turf_decal/bot_red,
/obj/effect/turf_decal/siding/wideplating_new{
	dir = 8
	},
/turf/open/floor/mineral/titanium/tiled,
/area/template_noop)
"o" = (
/turf/closed/wall/mineral/titanium,
/area/template_noop)
"t" = (
/obj/effect/turf_decal/siding/wideplating_new{
	dir = 8
	},
/obj/effect/turf_decal/siding/wideplating_new{
	dir = 4
	},
/turf/open/floor/mineral/titanium/blue,
/area/template_noop)
"C" = (
/obj/structure/chair/sofa/bench/left{
	dir = 1
	},
/turf/open/floor/mineral/titanium,
/area/template_noop)
"E" = (
/obj/structure/chair/sofa/bench/left,
/turf/open/floor/mineral/titanium,
/area/template_noop)
"H" = (
/obj/structure/window/reinforced/tram{
	dir = 8
	},
/obj/machinery/power/shuttle_engine/propulsion{
	dir = 4
	},
/obj/docking_port/mobile/arrivals{
	name = "foxhole arrivals shuttle"
	},
/obj/effect/turf_decal/stripes/line{
	dir = 4
	},
/obj/effect/turf_decal/stripes/red/line{
	dir = 4
	},
/turf/open/floor/plating,
/area/template_noop)
"J" = (
/turf/open/floor/mineral/titanium/tiled/blue,
/area/template_noop)
"M" = (
/obj/structure/chair/sofa/bench/right{
	dir = 1
	},
/turf/open/floor/mineral/titanium,
/area/template_noop)
"U" = (
/obj/effect/turf_decal/siding/wideplating_new{
	dir = 8
	},
/obj/effect/turf_decal/siding/wideplating_new{
	dir = 4
	},
/turf/open/floor/mineral/titanium/tiled/blue,
/area/template_noop)
"V" = (
/turf/open/floor/catwalk_floor/titanium,
/area/template_noop)
"W" = (
/obj/structure/chair/sofa/bench/right,
/turf/open/floor/mineral/titanium,
/area/template_noop)

(1,1,1) = {"
i
o
a
o
i
"}
(2,1,1) = {"
o
o
d
o
o
"}
(3,1,1) = {"
b
c
J
c
m
"}
(4,1,1) = {"
o
W
V
l
o
"}
(5,1,1) = {"
o
E
V
M
o
"}
(6,1,1) = {"
e
t
U
t
e
"}
(7,1,1) = {"
o
W
V
C
o
"}
(8,1,1) = {"
o
k
V
M
o
"}
(9,1,1) = {"
b
c
J
c
m
"}
(10,1,1) = {"
o
o
n
o
o
"}
(11,1,1) = {"
i
o
H
o
i
"}
