//MAP CONVERTED BY dmm2tgm.py THIS HEADER COMMENT PREVENTS RECONVERSION, DO NOT REMOVE
"a" = (
/obj/machinery/power/shuttle_engine/propulsion{
	dir = 8
	},
/obj/effect/turf_decal/stripes/line{
	dir = 8
	},
/obj/effect/turf_decal/stripes/red/line{
	dir = 8
	},
/obj/structure/window/reinforced/titanium/directional/east,
/turf/open/floor/plating,
/area/shuttle/arrival)
"b" = (
/obj/effect/turf_decal/stripes/line{
	dir = 1
	},
/obj/machinery/door/airlock/titanium,
/turf/open/floor/mineral/titanium/blue,
/area/shuttle/arrival)
"c" = (
/turf/open/floor/mineral/titanium/blue,
/area/shuttle/arrival)
"d" = (
/obj/structure/closet/emcloset/anchored,
/obj/effect/turf_decal/bot_red,
/obj/effect/turf_decal/siding/wideplating_new{
	dir = 4
	},
/turf/open/floor/mineral/titanium/tiled,
/area/shuttle/arrival)
"e" = (
/obj/effect/spawner/structure/window/reinforced/shuttle,
/turf/open/floor/plating,
/area/shuttle/arrival)
"i" = (
/turf/template_noop,
/area/template_noop)
"k" = (
/obj/structure/chair/sofa/bench/left,
/obj/machinery/light/cold/directional/north,
/turf/open/floor/mineral/titanium,
/area/shuttle/arrival)
"l" = (
/obj/structure/chair/sofa/bench/left{
	dir = 1
	},
/obj/machinery/light/cold/directional/south,
/turf/open/floor/mineral/titanium,
/area/shuttle/arrival)
"m" = (
/obj/effect/turf_decal/stripes/line,
/obj/machinery/door/airlock/titanium,
/turf/open/floor/mineral/titanium/blue,
/area/shuttle/arrival)
"n" = (
/obj/structure/closet/emcloset/anchored,
/obj/effect/turf_decal/bot_red,
/obj/effect/turf_decal/siding/wideplating_new{
	dir = 8
	},
/turf/open/floor/mineral/titanium/tiled,
/area/shuttle/arrival)
"o" = (
/turf/closed/wall/mineral/titanium,
/area/shuttle/arrival)
"t" = (
/obj/effect/turf_decal/siding/wideplating_new{
	dir = 8
	},
/obj/effect/turf_decal/siding/wideplating_new{
	dir = 4
	},
/turf/open/floor/mineral/titanium/blue,
/area/shuttle/arrival)
"z" = (
/turf/closed/wall/mineral/titanium/nodiagonal,
/area/shuttle/arrival)
"C" = (
/obj/structure/chair/sofa/bench/left{
	dir = 1
	},
/turf/open/floor/mineral/titanium,
/area/shuttle/arrival)
"E" = (
/obj/structure/chair/sofa/bench/left,
/turf/open/floor/mineral/titanium,
/area/shuttle/arrival)
"H" = (
/obj/machinery/power/shuttle_engine/propulsion{
	dir = 4
	},
/obj/docking_port/mobile/arrivals{
	name = "foxhole arrivals shuttle"
	},
/obj/effect/turf_decal/stripes/line{
	dir = 4
	},
/obj/effect/turf_decal/stripes/red/line{
	dir = 4
	},
/obj/structure/window/reinforced/titanium/directional/west,
/turf/open/floor/plating,
/area/shuttle/arrival)
"J" = (
/turf/open/floor/mineral/titanium/tiled/blue,
/area/shuttle/arrival)
"M" = (
/obj/structure/chair/sofa/bench/right{
	dir = 1
	},
/turf/open/floor/mineral/titanium,
/area/shuttle/arrival)
"U" = (
/obj/effect/turf_decal/siding/wideplating_new{
	dir = 8
	},
/obj/effect/turf_decal/siding/wideplating_new{
	dir = 4
	},
/turf/open/floor/mineral/titanium/tiled/blue,
/area/shuttle/arrival)
"V" = (
/turf/open/floor/catwalk_floor/titanium,
/area/shuttle/arrival)
"W" = (
/obj/structure/chair/sofa/bench/right,
/turf/open/floor/mineral/titanium,
/area/shuttle/arrival)

(1,1,1) = {"
i
o
a
o
i
"}
(2,1,1) = {"
o
z
d
z
o
"}
(3,1,1) = {"
b
c
J
c
m
"}
(4,1,1) = {"
o
W
V
l
o
"}
(5,1,1) = {"
o
E
V
M
o
"}
(6,1,1) = {"
e
t
U
t
e
"}
(7,1,1) = {"
o
W
V
C
o
"}
(8,1,1) = {"
o
k
V
M
o
"}
(9,1,1) = {"
b
c
J
c
m
"}
(10,1,1) = {"
o
z
n
z
o
"}
(11,1,1) = {"
i
o
H
o
i
"}
