//MAP CONVERTED BY dmm2tgm.py THIS HEADER COMMENT PREVENTS RECONVERSION, DO NOT REMOVE
"a" = (
/turf/open/floor/mineral/titanium/blue,
/area/shuttle/supply)
"b" = (
/obj/machinery/power/shuttle_engine/propulsion/burst/right,
/turf/open/floor/plating/airless,
/area/shuttle/supply)
"f" = (
/turf/closed/wall/mineral/titanium,
/area/shuttle/supply)
"h" = (
/turf/closed/wall/mineral/titanium/nodiagonal,
/area/shuttle/supply)
"k" = (
/obj/machinery/door/airlock/titanium{
	name = "Supply Shuttle Airlock"
	},
/obj/effect/mapping_helpers/airlock/access/all/supply/general,
/turf/open/floor/plating,
/area/shuttle/supply)
"l" = (
/turf/template_noop,
/area/template_noop)
"s" = (
/obj/structure/window/reinforced/spawner/directional/north,
/obj/machinery/power/shuttle_engine/heater,
/turf/open/floor/plating/airless,
/area/shuttle/supply)
"u" = (
/obj/machinery/conveyor{
	dir = 8;
	id = "QMLoad2"
	},
/obj/machinery/door/poddoor{
	id = "QMLoaddoor2";
	name = "Supply Dock Loading Door"
	},
/turf/open/floor/plating,
/area/shuttle/supply)
"v" = (
/obj/machinery/conveyor{
	dir = 4;
	id = "QMLoad"
	},
/obj/machinery/door/poddoor{
	id = "QMLoaddoor";
	name = "Supply Dock Loading Door"
	},
/turf/open/floor/plating,
/area/shuttle/supply)
"w" = (
/obj/machinery/door/airlock/titanium{
	name = "Supply Shuttle Airlock"
	},
/obj/docking_port/mobile/supply,
/obj/effect/mapping_helpers/airlock/access/all/supply/general,
/turf/open/floor/plating,
/area/shuttle/supply)
"F" = (
/obj/machinery/light/directional/west,
/turf/open/floor/mineral/titanium/blue,
/area/shuttle/supply)
"H" = (
/obj/machinery/power/shuttle_engine/propulsion/burst/left,
/turf/open/floor/plating/airless,
/area/shuttle/supply)
"J" = (
/obj/machinery/power/shuttle_engine/propulsion,
/turf/open/floor/plating/airless,
/area/shuttle/supply)
"L" = (
/obj/machinery/button/door/directional/east{
	id = "QMLoaddoor2";
	name = "Loading Doors";
	pixel_y = 8
	},
/obj/machinery/button/door/directional/east{
	id = "QMLoaddoor";
	name = "Loading Doors";
	pixel_y = -8
	},
/obj/machinery/light/directional/east,
/turf/open/floor/mineral/titanium/blue,
/area/shuttle/supply)
"T" = (
/turf/closed/wall/mineral/titanium/interior,
/area/shuttle/supply)

(1,1,1) = {"
f
f
h
f
f
f
f
f
h
f
l
"}
(2,1,1) = {"
f
a
a
a
a
F
a
a
T
f
H
"}
(3,1,1) = {"
f
a
a
a
a
a
a
a
a
s
J
"}
(4,1,1) = {"
f
a
a
a
a
a
a
a
a
s
J
"}
(5,1,1) = {"
f
a
a
a
a
L
a
a
T
f
b
"}
(6,1,1) = {"
f
f
h
u
k
f
w
v
h
f
l
"}
