//MAP CONVERTED BY dmm2tgm.py THIS HEADER COMMENT PREVENTS RECONVERSION, DO NOT REMOVE
"ao" = (
/obj/effect/turf_decal/siding/dark{
	dir = 4
	},
/obj/effect/turf_decal/trimline/purple/warning{
	dir = 4
	},
/obj/structure/railing{
	dir = 4
	},
/obj/structure/closet/secure_closet/personal,
/turf/open/floor/iron/dark,
/area/shuttle/escape)
"bf" = (
/obj/machinery/jukebox/disco,
/turf/open/floor/glass/reinforced,
/area/shuttle/escape)
"bE" = (
/obj/machinery/door/firedoor,
/obj/effect/turf_decal/siding/dark{
	dir = 4
	},
/turf/open/floor/pod/dark,
/area/shuttle/escape)
"bL" = (
/obj/effect/turf_decal/siding/dark{
	dir = 4
	},
/obj/structure/table/reinforced/plastitaniumglass,
/turf/open/floor/pod/dark,
/area/shuttle/escape)
"bS" = (
/obj/effect/turf_decal/trimline/blue/warning,
/turf/open/floor/pod/light,
/area/shuttle/escape)
"bU" = (
/obj/effect/turf_decal/tile/yellow/diagonal_edge,
/obj/effect/turf_decal/trimline/blue/warning{
	dir = 8
	},
/obj/effect/turf_decal/trimline/blue/mid_joiner{
	dir = 8
	},
/obj/structure/chair/stool/bar/directional/north,
/turf/open/floor/iron/dark/diagonal,
/area/shuttle/escape)
"cc" = (
/obj/effect/turf_decal/siding/dark{
	dir = 8
	},
/obj/effect/turf_decal/trimline/purple/warning{
	dir = 8
	},
/obj/structure/closet/secure_closet/personal,
/obj/structure/railing{
	dir = 8
	},
/obj/structure/sign/departments/cargo/directional/north{
	desc = "A sign labelling an area where luggage is stored.";
	name = "\improper Luggage sign"
	},
/turf/open/floor/iron/dark,
/area/shuttle/escape)
"ct" = (
/obj/structure/lattice,
/turf/template_noop,
/area/shuttle/escape)
"cM" = (
/obj/structure/chair/comfy/shuttle{
	dir = 1
	},
/turf/open/floor/iron,
/area/shuttle/escape)
"db" = (
/obj/effect/turf_decal/tile/yellow/diagonal_edge,
/obj/effect/turf_decal/siding/dark{
	dir = 1
	},
/turf/open/floor/iron/dark/diagonal,
/area/shuttle/escape)
"dy" = (
/obj/effect/turf_decal/stripes/corner{
	dir = 4
	},
/obj/effect/turf_decal/stripes/corner{
	dir = 1
	},
/obj/structure/reflector/box/mapping{
	dir = 1
	},
/turf/open/floor/plating,
/area/shuttle/escape)
"dL" = (
/turf/closed/wall/mineral/titanium/survival/nodiagonal,
/area/shuttle/escape)
"eK" = (
/obj/effect/turf_decal/siding/dark{
	dir = 4
	},
/turf/open/floor/pod/light,
/area/shuttle/escape)
"eT" = (
/obj/effect/turf_decal/tile/yellow/diagonal_edge,
/turf/open/floor/iron/dark/diagonal,
/area/shuttle/escape)
"fn" = (
/obj/effect/turf_decal/trimline/blue/warning{
	dir = 4
	},
/obj/effect/turf_decal/siding/wideplating_new/dark{
	dir = 8
	},
/turf/open/floor/iron/dark,
/area/shuttle/escape)
"fR" = (
/obj/effect/turf_decal/siding/dark/corner,
/turf/open/floor/pod/light,
/area/shuttle/escape)
"fS" = (
/obj/effect/turf_decal/siding/wideplating_new/dark{
	dir = 8
	},
/obj/effect/turf_decal/trimline/purple/warning{
	dir = 4
	},
/turf/open/floor/iron/dark,
/area/shuttle/escape)
"fU" = (
/obj/effect/turf_decal/trimline/purple/warning{
	dir = 4
	},
/turf/open/floor/pod/light,
/area/shuttle/escape)
"gn" = (
/turf/open/floor/iron/dark/side{
	dir = 6
	},
/area/shuttle/escape)
"gx" = (
/obj/effect/turf_decal/tile/yellow/diagonal_edge,
/obj/effect/turf_decal/siding/dark{
	dir = 1
	},
/obj/effect/turf_decal/trimline/blue/warning,
/turf/open/floor/iron/dark/diagonal,
/area/shuttle/escape)
"gE" = (
/turf/open/floor/catwalk_floor/iron_dark,
/area/shuttle/escape)
"gY" = (
/obj/effect/turf_decal/siding/dark,
/obj/structure/railing,
/obj/structure/window/reinforced/survival_pod{
	dir = 10
	},
/obj/structure/window/reinforced/survival_pod{
	dir = 6
	},
/obj/effect/turf_decal/trimline/brown/warning,
/turf/open/floor/pod/dark,
/area/shuttle/escape)
"hd" = (
/obj/effect/turf_decal/tile/yellow/diagonal_edge,
/obj/effect/turf_decal/trimline/blue/warning{
	dir = 4
	},
/obj/effect/turf_decal/trimline/blue/mid_joiner{
	dir = 4
	},
/obj/structure/table/reinforced/plastitaniumglass,
/turf/open/floor/iron/dark/diagonal,
/area/shuttle/escape)
"hp" = (
/obj/effect/turf_decal/tile/yellow/diagonal_edge,
/obj/structure/table/reinforced/plastitaniumglass,
/turf/open/floor/iron/dark/diagonal,
/area/shuttle/escape)
"hw" = (
/obj/structure/chair/comfy/shuttle{
	dir = 8
	},
/turf/open/floor/pod/dark,
/area/shuttle/escape)
"hT" = (
/obj/machinery/door/airlock/command,
/obj/effect/turf_decal/siding/wood{
	dir = 4
	},
/obj/effect/turf_decal/siding/wood{
	dir = 8
	},
/obj/effect/mapping_helpers/airlock/access/all/command/captain,
/turf/open/floor/wood/large,
/area/shuttle/escape)
"hY" = (
/obj/effect/turf_decal/tile/yellow/diagonal_edge,
/obj/effect/turf_decal/stripes/line,
/obj/structure/window/reinforced/survival_pod/spawner/directional/south,
/obj/structure/table/reinforced/plastitaniumglass,
/turf/open/floor/iron/dark/diagonal,
/area/shuttle/escape)
"iz" = (
/obj/structure/chair/comfy/shuttle{
	dir = 4
	},
/obj/structure/window/reinforced/survival_pod/spawner/directional/west,
/obj/structure/window/reinforced/survival_pod{
	dir = 9
	},
/obj/effect/turf_decal/trimline/green/warning{
	dir = 4
	},
/turf/open/floor/pod/dark,
/area/shuttle/escape)
"jh" = (
/obj/effect/turf_decal/tile/yellow/diagonal_edge,
/obj/effect/turf_decal/trimline/blue/warning{
	dir = 8
	},
/obj/effect/turf_decal/siding/dark{
	dir = 5
	},
/turf/open/floor/iron/dark/diagonal,
/area/shuttle/escape)
"ji" = (
/obj/effect/turf_decal/stripes/line{
	dir = 1
	},
/turf/open/floor/plating,
/area/shuttle/escape)
"jv" = (
/obj/effect/turf_decal/tile/yellow/diagonal_edge,
/obj/effect/turf_decal/stripes/corner{
	dir = 4
	},
/obj/structure/window/reinforced/survival_pod{
	dir = 5
	},
/turf/open/floor/iron/dark/diagonal,
/area/shuttle/escape)
"kj" = (
/obj/effect/turf_decal/trimline/blue/warning{
	dir = 8
	},
/obj/effect/turf_decal/siding/wideplating_new/dark{
	dir = 4
	},
/turf/open/floor/iron/dark,
/area/shuttle/escape)
"kv" = (
/obj/effect/turf_decal/trimline/blue/warning{
	dir = 1
	},
/obj/effect/turf_decal/trimline/blue/warning{
	dir = 4
	},
/obj/effect/turf_decal/siding/wideplating_new/dark/corner{
	dir = 8
	},
/turf/open/floor/iron/dark,
/area/shuttle/escape)
"ky" = (
/obj/effect/turf_decal/trimline/purple/warning,
/obj/effect/turf_decal/siding/wideplating_new/dark/corner{
	dir = 1
	},
/obj/effect/turf_decal/trimline/purple/warning{
	dir = 4
	},
/obj/effect/turf_decal/siding/dark,
/turf/open/floor/iron/dark,
/area/shuttle/escape)
"kX" = (
/turf/open/floor/pod/light,
/area/shuttle/escape)
"kY" = (
/obj/structure/table/reinforced/plastitaniumglass,
/turf/open/floor/pod/dark,
/area/shuttle/escape)
"lq" = (
/obj/structure/table/reinforced/plastitaniumglass,
/obj/effect/turf_decal/trimline/brown/warning,
/obj/effect/turf_decal/siding/dark{
	dir = 10
	},
/obj/structure/window/reinforced/survival_pod/spawner/directional/south,
/obj/structure/window/reinforced/survival_pod{
	dir = 10
	},
/turf/open/floor/pod/dark,
/area/shuttle/escape)
"lN" = (
/obj/effect/turf_decal/siding/dark{
	dir = 6
	},
/obj/effect/turf_decal/trimline/blue/warning{
	dir = 6
	},
/turf/open/floor/iron/dark,
/area/shuttle/escape)
"mc" = (
/obj/structure/window/reinforced/survival_pod/spawner/directional/north,
/obj/effect/turf_decal/stripes/end{
	dir = 1
	},
/turf/open/floor/plating,
/area/shuttle/escape)
"mj" = (
/obj/structure/chair/comfy/shuttle{
	dir = 8
	},
/obj/structure/window/reinforced/survival_pod/spawner/directional/east,
/obj/structure/window/reinforced/survival_pod{
	dir = 5
	},
/obj/effect/turf_decal/trimline/green/warning{
	dir = 8
	},
/turf/open/floor/pod/dark,
/area/shuttle/escape)
"mG" = (
/obj/effect/turf_decal/trimline/blue/warning,
/obj/effect/turf_decal/trimline/blue/warning{
	dir = 8
	},
/obj/effect/turf_decal/siding/dark,
/obj/effect/turf_decal/siding/wideplating_new/dark/corner{
	dir = 4
	},
/turf/open/floor/iron/dark,
/area/shuttle/escape)
"nc" = (
/obj/effect/turf_decal/trimline/purple/warning,
/obj/effect/turf_decal/siding/wideplating_new/dark/corner{
	dir = 4
	},
/obj/effect/turf_decal/trimline/purple/warning{
	dir = 8
	},
/obj/effect/turf_decal/siding/dark,
/turf/open/floor/iron/dark,
/area/shuttle/escape)
"nN" = (
/obj/effect/turf_decal/siding/dark{
	dir = 9
	},
/obj/effect/turf_decal/trimline/blue/warning{
	dir = 9
	},
/turf/open/floor/iron/dark,
/area/shuttle/escape)
"of" = (
/obj/effect/turf_decal/siding/dark,
/obj/effect/turf_decal/trimline/blue/warning,
/obj/effect/turf_decal/siding/wideplating_new/dark{
	dir = 1
	},
/turf/open/floor/iron/dark,
/area/shuttle/escape)
"oq" = (
/obj/structure/chair/comfy/shuttle{
	dir = 8
	},
/obj/structure/window/reinforced/survival_pod/spawner/directional/east,
/obj/structure/window/reinforced/survival_pod{
	dir = 5
	},
/turf/open/floor/pod/dark,
/area/shuttle/escape)
"or" = (
/obj/effect/turf_decal/tile/yellow/diagonal_edge,
/obj/effect/turf_decal/stripes/line{
	dir = 4
	},
/obj/structure/window/reinforced/survival_pod/spawner/directional/east,
/turf/open/floor/iron/dark/diagonal,
/area/shuttle/escape)
"oA" = (
/obj/machinery/door/airlock/external,
/obj/effect/mapping_helpers/airlock/autoname,
/obj/effect/mapping_helpers/airlock/cyclelink_helper{
	dir = 4
	},
/turf/open/floor/plating,
/area/shuttle/escape)
"oE" = (
/obj/machinery/computer/emergency_shuttle,
/turf/open/floor/iron/dark,
/area/shuttle/escape)
"pD" = (
/obj/effect/turf_decal/siding/dark,
/obj/structure/railing,
/obj/structure/window/reinforced/survival_pod{
	dir = 6
	},
/obj/structure/window/reinforced/survival_pod{
	dir = 10
	},
/obj/effect/turf_decal/trimline/brown/warning,
/turf/open/floor/pod/dark,
/area/shuttle/escape)
"pE" = (
/obj/effect/turf_decal/siding/dark/corner{
	dir = 4
	},
/obj/effect/turf_decal/trimline/purple/warning{
	dir = 1
	},
/obj/effect/turf_decal/siding/wideplating_new/dark/corner{
	dir = 8
	},
/obj/effect/turf_decal/trimline/purple/warning{
	dir = 4
	},
/turf/open/floor/iron/dark,
/area/shuttle/escape)
"pF" = (
/obj/effect/turf_decal/tile/yellow/diagonal_edge,
/obj/effect/turf_decal/stripes/corner,
/obj/structure/window/reinforced/survival_pod{
	dir = 6
	},
/obj/structure/chair/comfy/black{
	dir = 4
	},
/turf/open/floor/iron/dark/diagonal,
/area/shuttle/escape)
"qc" = (
/obj/structure/table/wood,
/obj/item/flashlight/lamp/green{
	pixel_y = 15;
	pixel_x = 8
	},
/turf/open/floor/carpet/executive,
/area/shuttle/escape)
"qG" = (
/obj/structure/closet/emcloset/anchored,
/turf/open/floor/pod/light,
/area/shuttle/escape)
"qN" = (
/obj/effect/turf_decal/siding/dark/corner,
/turf/open/floor/pod/dark,
/area/shuttle/escape)
"rM" = (
/obj/effect/turf_decal/tile/yellow/diagonal_edge,
/obj/structure/chair{
	dir = 8
	},
/turf/open/floor/iron/dark/diagonal,
/area/shuttle/escape)
"sd" = (
/obj/structure/chair/comfy/shuttle{
	dir = 4
	},
/turf/open/floor/pod/dark,
/area/shuttle/escape)
"sx" = (
/obj/effect/turf_decal/trimline/blue/warning{
	dir = 8
	},
/turf/open/floor/pod/light,
/area/shuttle/escape)
"sN" = (
/obj/effect/turf_decal/stripes/line{
	dir = 1
	},
/obj/item/laser_pointer/green,
/obj/item/assembly/signaler,
/turf/open/floor/plating,
/area/shuttle/escape)
"sZ" = (
/obj/machinery/chem_master/condimaster{
	desc = "Used to separate out liquids - useful for purifying botanical extracts. Also dispenses condiments.";
	name = "BrewMaster 2199"
	},
/turf/open/floor/pod/dark,
/area/shuttle/escape)
"tl" = (
/turf/open/floor/iron/dark,
/area/shuttle/escape)
"ty" = (
/obj/effect/turf_decal/siding/dark{
	dir = 4
	},
/turf/open/floor/pod/dark,
/area/shuttle/escape)
"tL" = (
/obj/effect/turf_decal/tile/yellow/diagonal_edge,
/obj/effect/turf_decal/trimline/blue/warning{
	dir = 4
	},
/obj/effect/turf_decal/trimline/blue/mid_joiner{
	dir = 4
	},
/obj/effect/turf_decal/siding/dark{
	dir = 1
	},
/obj/structure/chair/stool/bar/directional/south,
/turf/open/floor/iron/dark/diagonal,
/area/shuttle/escape)
"ue" = (
/obj/machinery/firealarm/directional/west,
/obj/effect/turf_decal/siding/dark/corner{
	dir = 1
	},
/turf/open/floor/pod/light,
/area/shuttle/escape)
"vX" = (
/obj/effect/spawner/structure/window/survival_pod,
/turf/open/floor/plating,
/area/shuttle/escape)
"wv" = (
/obj/effect/turf_decal/tile/yellow/diagonal_edge,
/obj/effect/turf_decal/siding/dark/corner{
	dir = 4
	},
/obj/effect/turf_decal/trimline/blue/warning{
	dir = 10
	},
/turf/open/floor/iron/dark/diagonal,
/area/shuttle/escape)
"xa" = (
/obj/effect/turf_decal/tile/yellow/diagonal_edge,
/obj/effect/turf_decal/trimline/blue/warning{
	dir = 8
	},
/obj/effect/turf_decal/trimline/blue/mid_joiner{
	dir = 8
	},
/obj/structure/table/reinforced/plastitaniumglass,
/turf/open/floor/iron/dark/diagonal,
/area/shuttle/escape)
"xf" = (
/obj/effect/turf_decal/siding/dark,
/turf/open/floor/pod/light,
/area/shuttle/escape)
"xu" = (
/obj/effect/turf_decal/tile/yellow/diagonal_edge,
/obj/effect/turf_decal/stripes/corner{
	dir = 1
	},
/obj/structure/window/reinforced/survival_pod{
	dir = 9
	},
/turf/open/floor/iron/dark/diagonal,
/area/shuttle/escape)
"ym" = (
/obj/effect/turf_decal/siding/dark{
	dir = 10
	},
/obj/effect/turf_decal/trimline/purple/warning{
	dir = 10
	},
/turf/open/floor/iron/dark,
/area/shuttle/escape)
"zz" = (
/obj/item/grenade/gas_crystal/crystal_foam,
/turf/open/floor/engine,
/area/shuttle/escape)
"zD" = (
/obj/effect/turf_decal/trimline/purple/warning{
	dir = 1
	},
/obj/effect/turf_decal/siding/wideplating_new/dark/corner,
/obj/effect/turf_decal/trimline/purple/warning{
	dir = 8
	},
/obj/structure/rack,
/obj/effect/spawner/random/bureaucracy/briefcase,
/turf/open/floor/iron/dark,
/area/shuttle/escape)
"AY" = (
/obj/effect/turf_decal/trimline/blue/warning,
/obj/effect/turf_decal/trimline/blue/warning{
	dir = 4
	},
/obj/effect/turf_decal/siding/dark,
/obj/effect/turf_decal/siding/wideplating_new/dark/corner{
	dir = 1
	},
/turf/open/floor/iron/dark,
/area/shuttle/escape)
"AZ" = (
/obj/effect/turf_decal/siding/wideplating_new/dark{
	dir = 4
	},
/obj/effect/turf_decal/trimline/purple/warning{
	dir = 8
	},
/turf/open/floor/iron/dark,
/area/shuttle/escape)
"BA" = (
/obj/effect/turf_decal/siding/dark{
	dir = 10
	},
/obj/effect/turf_decal/trimline/blue/warning{
	dir = 10
	},
/turf/open/floor/iron/dark,
/area/shuttle/escape)
"Cg" = (
/obj/structure/table/wood,
/obj/item/flashlight/lamp/green{
	pixel_y = 15;
	pixel_x = -8
	},
/turf/open/floor/carpet/blue,
/area/shuttle/escape)
"Cn" = (
/obj/structure/table/reinforced/plastitaniumglass,
/obj/machinery/reagentgrinder{
	pixel_y = 8
	},
/turf/open/floor/pod/dark,
/area/shuttle/escape)
"Cp" = (
/obj/effect/turf_decal/trimline/purple/warning,
/turf/open/floor/pod/light,
/area/shuttle/escape)
"CO" = (
/obj/effect/turf_decal/tile/yellow/diagonal_edge,
/obj/effect/turf_decal/trimline/blue/warning{
	dir = 4
	},
/obj/effect/turf_decal/siding/dark{
	dir = 9
	},
/turf/open/floor/iron/dark/diagonal,
/area/shuttle/escape)
"Da" = (
/obj/structure/chair/comfy/shuttle{
	dir = 8
	},
/obj/structure/window/reinforced/survival_pod/spawner/directional/east,
/turf/open/floor/pod/dark,
/area/shuttle/escape)
"DD" = (
/obj/structure/bed/double{
	dir = 1
	},
/obj/item/bedsheet/hop/double{
	dir = 1
	},
/turf/open/floor/carpet/blue,
/area/shuttle/escape)
"DG" = (
/obj/structure/chair/comfy/shuttle{
	dir = 4
	},
/obj/structure/window/reinforced/survival_pod/spawner/directional/west,
/obj/effect/turf_decal/trimline/green/warning{
	dir = 4
	},
/turf/open/floor/pod/dark,
/area/shuttle/escape)
"DH" = (
/obj/effect/turf_decal/siding/dark/corner{
	dir = 8
	},
/turf/open/floor/pod/light,
/area/shuttle/escape)
"EO" = (
/obj/machinery/vending/boozeomat,
/turf/open/floor/pod/dark,
/area/shuttle/escape)
"EW" = (
/obj/effect/turf_decal/tile/yellow/diagonal_edge,
/obj/structure/chair,
/turf/open/floor/iron/dark/diagonal,
/area/shuttle/escape)
"EY" = (
/turf/open/floor/catwalk_floor/iron_dark/airless,
/area/shuttle/escape)
"FU" = (
/obj/structure/lattice/catwalk,
/obj/structure/marker_beacon/burgundy,
/turf/template_noop,
/area/shuttle/escape)
"FZ" = (
/turf/open/floor/glass/reinforced,
/area/shuttle/escape)
"Gn" = (
/obj/effect/turf_decal/siding/dark,
/obj/effect/turf_decal/trimline/purple/warning,
/obj/effect/turf_decal/siding/wideplating_new/dark{
	dir = 1
	},
/turf/open/floor/iron/dark,
/area/shuttle/escape)
"Gy" = (
/obj/effect/turf_decal/tile/yellow/diagonal_edge,
/obj/effect/turf_decal/stripes/line{
	dir = 8
	},
/obj/structure/window/reinforced/survival_pod/spawner/directional/west,
/turf/open/floor/iron/dark/diagonal,
/area/shuttle/escape)
"GL" = (
/obj/structure/table/reinforced/plastitaniumglass,
/obj/machinery/chem_dispenser/drinks,
/turf/open/floor/pod/dark,
/area/shuttle/escape)
"GP" = (
/obj/effect/turf_decal/tile/yellow/diagonal_edge,
/obj/effect/turf_decal/trimline/blue/warning{
	dir = 4
	},
/obj/effect/turf_decal/trimline/blue/mid_joiner{
	dir = 4
	},
/obj/structure/chair/stool/bar/directional/north,
/turf/open/floor/iron/dark/diagonal,
/area/shuttle/escape)
"GV" = (
/obj/effect/turf_decal/siding/dark,
/obj/structure/window/reinforced/survival_pod/spawner/directional/south,
/obj/effect/turf_decal/trimline/brown/warning,
/turf/open/floor/pod/dark,
/area/shuttle/escape)
"Im" = (
/obj/effect/turf_decal/siding/dark{
	dir = 5
	},
/obj/effect/turf_decal/trimline/purple/warning{
	dir = 5
	},
/turf/open/floor/iron/dark,
/area/shuttle/escape)
"IB" = (
/obj/machinery/door/airlock/external,
/obj/effect/mapping_helpers/airlock/autoname,
/obj/effect/mapping_helpers/airlock/cyclelink_helper{
	dir = 4
	},
/obj/docking_port/mobile/emergency{
	name = "Novelty Micro-Hole emergency shuttle"
	},
/turf/open/floor/plating,
/area/shuttle/escape)
"Jk" = (
/obj/machinery/door/firedoor,
/turf/open/floor/pod/light,
/area/shuttle/escape)
"Jr" = (
/obj/effect/turf_decal/siding/dark/corner{
	dir = 4
	},
/turf/open/floor/pod/light,
/area/shuttle/escape)
"JC" = (
/obj/structure/chair/comfy/shuttle{
	dir = 8
	},
/obj/structure/window/reinforced/survival_pod/spawner/directional/east,
/obj/effect/turf_decal/trimline/green/warning{
	dir = 8
	},
/turf/open/floor/pod/dark,
/area/shuttle/escape)
"KO" = (
/obj/effect/turf_decal/siding/dark{
	dir = 8
	},
/obj/structure/table/reinforced/plastitaniumglass,
/turf/open/floor/pod/dark,
/area/shuttle/escape)
"KZ" = (
/obj/structure/bed/double,
/obj/item/bedsheet/captain/double,
/turf/open/floor/carpet/executive,
/area/shuttle/escape)
"Lt" = (
/obj/effect/turf_decal/tile/yellow/diagonal_edge,
/obj/effect/turf_decal/stripes/corner{
	dir = 8
	},
/obj/structure/window/reinforced/survival_pod{
	dir = 10
	},
/obj/structure/chair/comfy/black{
	dir = 8
	},
/turf/open/floor/iron/dark/diagonal,
/area/shuttle/escape)
"LC" = (
/turf/open/floor/wood,
/area/shuttle/escape)
"Mk" = (
/obj/effect/turf_decal/siding/dark{
	dir = 8
	},
/turf/open/floor/pod/light,
/area/shuttle/escape)
"Mv" = (
/obj/effect/turf_decal/tile/yellow/diagonal_edge,
/obj/structure/chair{
	dir = 4
	},
/turf/open/floor/iron/dark/diagonal,
/area/shuttle/escape)
"Nn" = (
/obj/effect/turf_decal/siding/dark{
	dir = 8
	},
/obj/effect/turf_decal/trimline/purple/warning{
	dir = 8
	},
/obj/structure/closet/secure_closet/personal,
/obj/structure/railing{
	dir = 8
	},
/turf/open/floor/iron/dark,
/area/shuttle/escape)
"Oa" = (
/obj/effect/turf_decal/siding/dark{
	dir = 4
	},
/obj/effect/turf_decal/trimline/blue/warning{
	dir = 4
	},
/obj/structure/railing{
	dir = 4
	},
/turf/open/floor/iron/dark,
/area/shuttle/escape)
"Pk" = (
/obj/effect/turf_decal/tile/yellow/diagonal_edge,
/obj/effect/turf_decal/siding/dark/corner{
	dir = 1
	},
/obj/effect/turf_decal/trimline/blue/warning{
	dir = 6
	},
/turf/open/floor/iron/dark/diagonal,
/area/shuttle/escape)
"Pv" = (
/obj/effect/turf_decal/siding/dark,
/obj/effect/turf_decal/trimline/brown/warning,
/turf/open/floor/pod/dark,
/area/shuttle/escape)
"PF" = (
/obj/effect/turf_decal/tile/yellow/diagonal_edge,
/obj/effect/turf_decal/trimline/blue/warning{
	dir = 8
	},
/obj/effect/turf_decal/trimline/blue/mid_joiner{
	dir = 8
	},
/obj/effect/turf_decal/siding/dark{
	dir = 1
	},
/obj/structure/chair/stool/bar/directional/south,
/turf/open/floor/iron/dark/diagonal,
/area/shuttle/escape)
"QF" = (
/obj/machinery/door/airlock/command,
/obj/effect/turf_decal/siding/wood{
	dir = 4
	},
/obj/effect/turf_decal/siding/wood{
	dir = 8
	},
/obj/effect/mapping_helpers/airlock/access/all/command/hop,
/turf/open/floor/wood/large,
/area/shuttle/escape)
"Rw" = (
/obj/effect/turf_decal/siding/dark{
	dir = 8
	},
/obj/effect/turf_decal/trimline/blue/warning{
	dir = 8
	},
/obj/structure/railing{
	dir = 8
	},
/turf/open/floor/iron/dark,
/area/shuttle/escape)
"RU" = (
/obj/machinery/door/airlock/command,
/obj/effect/mapping_helpers/airlock/access/all/command/general,
/turf/open/floor/iron/dark/textured_large,
/area/shuttle/escape)
"Sd" = (
/obj/structure/chair/comfy/shuttle{
	dir = 4
	},
/obj/structure/window/reinforced/survival_pod/spawner/directional/west,
/obj/structure/window/reinforced/survival_pod{
	dir = 9
	},
/turf/open/floor/pod/dark,
/area/shuttle/escape)
"Sf" = (
/obj/structure/chair/comfy/shuttle{
	dir = 4
	},
/obj/structure/window/reinforced/survival_pod/spawner/directional/west,
/turf/open/floor/pod/dark,
/area/shuttle/escape)
"SA" = (
/obj/effect/turf_decal/trimline/blue/warning{
	dir = 1
	},
/obj/effect/turf_decal/siding/wideplating_new/dark,
/turf/open/floor/iron/dark,
/area/shuttle/escape)
"SK" = (
/obj/effect/turf_decal/trimline/purple/warning{
	dir = 1
	},
/obj/effect/turf_decal/siding/wideplating_new/dark,
/obj/vehicle/ridden/wheelchair,
/turf/open/floor/iron/dark,
/area/shuttle/escape)
"SX" = (
/obj/effect/turf_decal/siding/dark/corner{
	dir = 1
	},
/obj/effect/turf_decal/trimline/blue/warning{
	dir = 1
	},
/obj/effect/turf_decal/trimline/blue/warning{
	dir = 8
	},
/obj/effect/turf_decal/siding/wideplating_new/dark/corner,
/turf/open/floor/iron/dark,
/area/shuttle/escape)
"TB" = (
/obj/machinery/computer/communications,
/turf/open/floor/iron/dark/side{
	dir = 9
	},
/area/shuttle/escape)
"TH" = (
/obj/machinery/firealarm/directional/east,
/turf/open/floor/pod/light,
/area/shuttle/escape)
"Ui" = (
/obj/effect/turf_decal/tile/yellow/diagonal_edge,
/obj/effect/turf_decal/siding/dark{
	dir = 1
	},
/obj/structure/chair/comfy/black,
/obj/effect/turf_decal/trimline/blue/warning,
/turf/open/floor/iron/dark/diagonal,
/area/shuttle/escape)
"Ux" = (
/obj/effect/turf_decal/siding/dark{
	dir = 8
	},
/turf/open/floor/pod/dark,
/area/shuttle/escape)
"Wf" = (
/obj/machinery/door/airlock/external,
/obj/effect/mapping_helpers/airlock/autoname,
/obj/effect/mapping_helpers/airlock/cyclelink_helper{
	dir = 8
	},
/turf/open/floor/plating,
/area/shuttle/escape)
"WT" = (
/obj/structure/table/reinforced/plastitaniumglass,
/obj/machinery/chem_dispenser/drinks/beer,
/turf/open/floor/pod/dark,
/area/shuttle/escape)
"XK" = (
/turf/open/floor/pod/dark,
/area/shuttle/escape)
"XU" = (
/obj/structure/table/reinforced/plastitaniumglass,
/obj/effect/turf_decal/trimline/brown/warning,
/obj/effect/turf_decal/siding/dark{
	dir = 6
	},
/obj/structure/window/reinforced/survival_pod/spawner/directional/south,
/obj/structure/window/reinforced/survival_pod{
	dir = 6
	},
/turf/open/floor/pod/dark,
/area/shuttle/escape)
"Yi" = (
/turf/open/floor/plating,
/area/shuttle/escape)
"Yl" = (
/obj/effect/turf_decal/siding/dark/corner{
	dir = 8
	},
/turf/open/floor/pod/dark,
/area/shuttle/escape)
"Yn" = (
/obj/machinery/computer/crew,
/turf/open/floor/iron/dark/side{
	dir = 5
	},
/area/shuttle/escape)
"Yv" = (
/obj/structure/closet/secure_closet/personal/cabinet,
/turf/open/floor/wood,
/area/shuttle/escape)
"Za" = (
/obj/machinery/door/firedoor,
/obj/effect/turf_decal/siding/dark{
	dir = 8
	},
/turf/open/floor/pod/dark,
/area/shuttle/escape)
"Zf" = (
/obj/item/orion_ship,
/obj/structure/lattice,
/turf/template_noop,
/area/shuttle/escape)
"Zw" = (
/obj/effect/turf_decal/siding/dark{
	dir = 6
	},
/obj/effect/turf_decal/trimline/purple/warning{
	dir = 6
	},
/turf/open/floor/iron/dark,
/area/shuttle/escape)
"ZG" = (
/turf/template_noop,
/area/template_noop)
"ZZ" = (
/turf/open/floor/iron/dark/side{
	dir = 10
	},
/area/shuttle/escape)

(1,1,1) = {"
ZG
ZG
ZG
ZG
ZG
ZG
ZG
ZG
ZG
ZG
ZG
dL
oA
dL
ZG
dL
IB
dL
ZG
ZG
ZG
ZG
ZG
ZG
ZG
ZG
ZG
ZG
ZG
ZG
ZG
ZG
ZG
ZG
ZG
"}
(2,1,1) = {"
ZG
ZG
ZG
ZG
ZG
ZG
ZG
ZG
ZG
ZG
ZG
dL
Yi
dL
dL
dL
Yi
dL
ZG
ZG
ZG
ZG
ZG
ZG
ZG
ZG
ZG
ZG
ZG
ZG
ZG
ZG
ZG
ZG
ZG
"}
(3,1,1) = {"
ZG
ZG
ZG
ZG
ZG
ZG
ZG
ZG
ZG
ZG
ZG
dL
Wf
dL
qG
dL
Wf
dL
dL
dL
dL
dL
dL
ZG
ZG
ZG
ZG
ZG
ZG
ZG
ZG
ZG
ZG
ZG
ZG
"}
(4,1,1) = {"
ZG
ZG
ZG
ZG
ZG
ZG
ZG
ZG
ZG
ZG
ZG
dL
kX
kX
kX
kX
kX
dL
XK
XK
XK
XK
dL
dL
dL
dL
dL
dL
ZG
ZG
ZG
ZG
ZG
ZG
ZG
"}
(5,1,1) = {"
ZG
ZG
ZG
ZG
ZG
ZG
ZG
ZG
ZG
ZG
dL
dL
cc
Nn
Nn
ym
kX
dL
XK
XK
XK
XK
XK
XK
XK
XK
XK
dL
dL
dL
dL
dL
ZG
ZG
ZG
"}
(6,1,1) = {"
ZG
ZG
ZG
dL
dL
dL
dL
dL
dL
dL
dL
zD
AZ
AZ
AZ
nc
kX
XK
XK
XK
XK
XK
XK
XK
XK
XK
XK
XK
XK
XK
XK
dL
dL
ZG
ZG
"}
(7,1,1) = {"
ZG
ZG
dL
dL
XK
XK
XK
XK
XK
XK
dL
SK
FZ
FZ
FZ
Gn
kX
XK
XK
XK
XK
XK
XK
XK
XK
XK
XK
XK
XK
XK
XK
XK
dL
ZG
ZG
"}
(8,1,1) = {"
ZG
dL
dL
XK
XK
XK
XK
XK
XK
XK
dL
pE
fS
fS
fS
ky
kX
XK
XK
XK
XK
XK
XK
XK
XK
XK
XK
XK
dL
dL
dL
dL
dL
ZG
ZG
"}
(9,1,1) = {"
ZG
dL
XK
XK
qN
ty
ty
ty
ty
ty
bE
Im
ao
ao
ao
Zw
fU
XK
XK
XK
XK
XK
XK
XK
XK
XK
XK
XK
dL
ZG
ZG
ZG
ZG
ZG
ZG
"}
(10,1,1) = {"
ZG
dL
dL
dL
dL
fR
eK
eK
eK
Jr
Jk
TH
kX
kX
kX
Cp
gE
dL
dL
dL
dL
XK
XK
XK
XK
XK
XK
XK
dL
ZG
ZG
ZG
ZG
ZG
ZG
"}
(11,1,1) = {"
dL
dL
Cg
DD
dL
xf
iz
DG
DG
dL
dL
dL
dL
dL
KO
lq
kX
PF
xa
bU
dL
dL
dL
XK
XK
XK
XK
XK
dL
ZG
ZG
ZG
ZG
ZG
ZG
"}
(12,1,1) = {"
dL
Yv
LC
LC
dL
xf
EY
EY
EY
dL
ZG
ZG
ZG
dL
EO
Pv
kX
db
eT
eT
EW
hp
dL
XK
XK
XK
XK
XK
dL
dL
dL
dL
dL
dL
ZG
"}
(13,1,1) = {"
dL
dL
QF
dL
dL
xf
oq
Da
Da
dL
ct
FU
ct
dL
sZ
GV
kX
jh
wv
eT
eT
rM
dL
dL
XK
XK
XK
XK
XK
XK
XK
XK
XK
dL
dL
"}
(14,1,1) = {"
vX
TB
tl
ZZ
dL
xf
sd
sd
sd
vX
ZG
ZG
ZG
vX
kY
gY
kX
kX
gx
pF
or
jv
sN
dL
XK
XK
XK
XK
XK
XK
XK
XK
XK
XK
dL
"}
(15,1,1) = {"
vX
oE
cM
tl
RU
xf
EY
EY
EY
vX
ct
Zf
ct
vX
WT
GV
kX
kX
Ui
hY
zz
mc
dy
dL
XK
XK
XK
XK
XK
XK
XK
XK
XK
XK
dL
"}
(16,1,1) = {"
vX
Yn
tl
gn
dL
xf
hw
hw
hw
vX
ZG
ZG
ZG
vX
GL
pD
kX
kX
gx
Lt
Gy
xu
ji
dL
XK
XK
XK
XK
XK
XK
XK
XK
XK
XK
dL
"}
(17,1,1) = {"
dL
dL
hT
dL
dL
xf
Sd
Sf
Sf
dL
ct
FU
ct
dL
Cn
GV
kX
CO
Pk
eT
eT
Mv
dL
dL
XK
XK
XK
XK
XK
XK
XK
XK
XK
dL
dL
"}
(18,1,1) = {"
dL
Yv
LC
LC
dL
xf
EY
EY
EY
dL
ZG
ZG
ZG
dL
XK
Pv
kX
db
eT
eT
EW
hp
dL
XK
XK
XK
XK
XK
dL
dL
dL
dL
dL
dL
ZG
"}
(19,1,1) = {"
dL
dL
qc
KZ
dL
xf
mj
JC
JC
dL
dL
dL
dL
dL
bL
XU
kX
tL
hd
GP
dL
dL
dL
XK
XK
XK
XK
XK
dL
ZG
ZG
ZG
ZG
ZG
ZG
"}
(20,1,1) = {"
ZG
dL
dL
dL
dL
DH
Mk
Mk
Mk
ue
Jk
kX
kX
kX
kX
bS
gE
dL
dL
dL
dL
XK
XK
XK
XK
XK
XK
XK
dL
ZG
ZG
ZG
ZG
ZG
ZG
"}
(21,1,1) = {"
ZG
dL
XK
XK
Yl
Ux
Ux
Ux
Ux
Ux
Za
nN
Rw
Rw
Rw
BA
sx
XK
XK
XK
XK
XK
XK
XK
XK
XK
XK
XK
dL
ZG
ZG
ZG
ZG
ZG
ZG
"}
(22,1,1) = {"
ZG
dL
dL
XK
XK
XK
XK
XK
XK
XK
dL
SX
kj
kj
kj
mG
kX
XK
XK
XK
XK
XK
XK
XK
XK
XK
XK
XK
dL
dL
dL
dL
dL
ZG
ZG
"}
(23,1,1) = {"
ZG
ZG
dL
dL
XK
XK
XK
XK
XK
XK
dL
SA
FZ
bf
FZ
of
kX
XK
XK
XK
XK
XK
XK
XK
XK
XK
XK
XK
XK
XK
XK
XK
dL
ZG
ZG
"}
(24,1,1) = {"
ZG
ZG
ZG
dL
dL
dL
dL
dL
dL
dL
dL
kv
fn
fn
fn
AY
kX
XK
XK
XK
XK
XK
XK
XK
XK
XK
XK
XK
XK
XK
XK
dL
dL
ZG
ZG
"}
(25,1,1) = {"
ZG
ZG
ZG
ZG
ZG
ZG
ZG
ZG
ZG
ZG
dL
dL
Oa
Oa
Oa
lN
kX
XK
XK
XK
XK
XK
XK
XK
XK
XK
XK
dL
dL
dL
dL
dL
ZG
ZG
ZG
"}
(26,1,1) = {"
ZG
ZG
ZG
ZG
ZG
ZG
ZG
ZG
ZG
ZG
ZG
dL
kX
kX
kX
kX
kX
XK
XK
XK
XK
XK
dL
dL
dL
dL
dL
dL
ZG
ZG
ZG
ZG
ZG
ZG
ZG
"}
(27,1,1) = {"
ZG
ZG
ZG
ZG
ZG
ZG
ZG
ZG
ZG
ZG
ZG
dL
oA
dL
qG
dL
oA
dL
dL
dL
dL
dL
dL
ZG
ZG
ZG
ZG
ZG
ZG
ZG
ZG
ZG
ZG
ZG
ZG
"}
(28,1,1) = {"
ZG
ZG
ZG
ZG
ZG
ZG
ZG
ZG
ZG
ZG
ZG
dL
Yi
dL
dL
dL
Yi
dL
ZG
ZG
ZG
ZG
ZG
ZG
ZG
ZG
ZG
ZG
ZG
ZG
ZG
ZG
ZG
ZG
ZG
"}
(29,1,1) = {"
ZG
ZG
ZG
ZG
ZG
ZG
ZG
ZG
ZG
ZG
ZG
dL
Wf
dL
ZG
dL
Wf
dL
ZG
ZG
ZG
ZG
ZG
ZG
ZG
ZG
ZG
ZG
ZG
ZG
ZG
ZG
ZG
ZG
ZG
"}
