//MAP CONVERTED BY dmm2tgm.py THIS HEADER COMMENT PREVENTS RECONVERSION, DO NOT REMOVE
"a" = (
/obj/effect/turf_decal/siding/wideplating_new{
	dir = 6
	},
/turf/open/floor/pod/dark,
/area/shuttle/interlink)
"b" = (
/obj/effect/turf_decal/siding/wideplating_new{
	dir = 5
	},
/obj/structure/chair/sofa/bench/left,
/obj/machinery/light/directional/north,
/turf/open/floor/pod/light,
/area/shuttle/interlink)
"c" = (
/obj/effect/turf_decal/siding/wideplating_new{
	dir = 1
	},
/obj/structure/chair/sofa/bench/left,
/turf/open/floor/pod/dark,
/area/shuttle/interlink)
"d" = (
/turf/open/floor/iron/large,
/area/shuttle/interlink)
"k" = (
/obj/effect/turf_decal/box/white/corners{
	dir = 8
	},
/obj/effect/turf_decal/box/white/corners{
	dir = 1
	},
/turf/open/floor/mineral/titanium/blue,
/area/shuttle/interlink)
"o" = (
/turf/template_noop,
/area/template_noop)
"p" = (
/obj/effect/turf_decal/siding/wideplating_new,
/obj/effect/turf_decal/siding/wideplating_new{
	dir = 1
	},
/turf/open/floor/pod/dark,
/area/shuttle/interlink)
"t" = (
/obj/effect/turf_decal/siding/wideplating_new{
	dir = 1
	},
/obj/structure/chair/sofa/bench/right,
/turf/open/floor/pod/dark,
/area/shuttle/interlink)
"u" = (
/obj/effect/turf_decal/siding/wideplating_new,
/obj/effect/turf_decal/siding/wideplating_new{
	dir = 1
	},
/obj/machinery/door/airlock/external/ruin/interlink_ferry,
/obj/effect/mapping_helpers/airlock/cyclelink_helper_multi{
	cycle_id = "interlinkblaster"
	},
/turf/open/floor/iron/smooth_large,
/area/shuttle/interlink)
"v" = (
/obj/effect/turf_decal/siding/wideplating_new{
	dir = 1
	},
/obj/effect/turf_decal/siding/wideplating_new,
/obj/machinery/door/airlock/external/ruin/interlink_ferry,
/obj/effect/mapping_helpers/airlock/cyclelink_helper_multi{
	cycle_id = "interlinkblaster"
	},
/turf/open/floor/iron/smooth_large,
/area/shuttle/interlink)
"w" = (
/obj/effect/turf_decal/siding/wideplating_new{
	dir = 10
	},
/obj/structure/chair/sofa/bench/left{
	dir = 1
	},
/obj/machinery/light/directional/south,
/turf/open/floor/pod/light,
/area/shuttle/interlink)
"z" = (
/obj/effect/spawner/structure/window/reinforced/shuttle,
/turf/open/floor/plating,
/area/shuttle/interlink)
"A" = (
/obj/effect/turf_decal/siding/wideplating_new,
/obj/structure/chair/sofa/bench/right{
	dir = 1
	},
/turf/open/floor/pod/dark,
/area/shuttle/interlink)
"B" = (
/obj/effect/turf_decal/siding/wideplating_new/corner,
/obj/effect/turf_decal/siding/wideplating_new/corner{
	dir = 4
	},
/turf/open/floor/pod/light,
/area/shuttle/interlink)
"C" = (
/obj/effect/turf_decal/siding/wideplating_new{
	dir = 9
	},
/turf/open/floor/pod/dark,
/area/shuttle/interlink)
"D" = (
/obj/effect/turf_decal/siding/wideplating_new/corner{
	dir = 1
	},
/obj/effect/turf_decal/siding/wideplating_new/corner{
	dir = 8
	},
/turf/open/floor/pod/light,
/area/shuttle/interlink)
"F" = (
/turf/open/floor/mineral/titanium/blue,
/area/shuttle/interlink)
"G" = (
/obj/effect/turf_decal/box/white,
/turf/open/floor/mineral/titanium/blue,
/area/shuttle/interlink)
"H" = (
/obj/effect/turf_decal/siding/wideplating_new{
	dir = 5
	},
/turf/open/floor/pod/dark,
/area/shuttle/interlink)
"J" = (
/turf/open/floor/pod/light,
/area/shuttle/interlink)
"K" = (
/obj/effect/turf_decal/siding/wideplating_new{
	dir = 10
	},
/turf/open/floor/pod/dark,
/area/shuttle/interlink)
"L" = (
/obj/effect/turf_decal/box/white/corners,
/obj/effect/turf_decal/box/white/corners{
	dir = 4
	},
/turf/open/floor/mineral/titanium/blue,
/area/shuttle/interlink)
"M" = (
/obj/machinery/power/shuttle_engine/propulsion{
	dir = 8
	},
/turf/open/floor/plating,
/area/shuttle/interlink)
"N" = (
/obj/effect/turf_decal/siding/wideplating_new{
	dir = 8
	},
/turf/open/floor/pod/light,
/area/shuttle/interlink)
"Q" = (
/obj/effect/turf_decal/siding/wideplating_new{
	dir = 9
	},
/obj/structure/chair/sofa/bench/right,
/turf/open/floor/pod/light,
/area/shuttle/interlink)
"R" = (
/obj/effect/turf_decal/siding/wideplating_new,
/obj/structure/chair/sofa/bench/left{
	dir = 1
	},
/turf/open/floor/pod/dark,
/area/shuttle/interlink)
"S" = (
/obj/effect/turf_decal/siding/wideplating_new{
	dir = 6
	},
/obj/structure/chair/sofa/bench/right{
	dir = 1
	},
/turf/open/floor/pod/light,
/area/shuttle/interlink)
"U" = (
/turf/closed/wall/mineral/titanium/nodiagonal,
/area/shuttle/interlink)
"W" = (
/obj/effect/turf_decal/siding/wideplating_new{
	dir = 4
	},
/turf/open/floor/pod/light,
/area/shuttle/interlink)
"X" = (
/obj/machinery/computer/shuttle/interlink,
/turf/open/floor/mineral/titanium/blue,
/area/shuttle/interlink)
"Y" = (
/obj/machinery/power/shuttle_engine/heater{
	dir = 8
	},
/obj/structure/window/reinforced/titanium/directional/east,
/turf/open/floor/plating,
/area/shuttle/interlink)
"Z" = (
/obj/effect/turf_decal/siding/wideplating_new{
	dir = 8
	},
/obj/effect/turf_decal/siding/wideplating_new{
	dir = 4
	},
/obj/machinery/door/airlock/external/ruin/interlink_ferry/opens_at_station,
/obj/effect/mapping_helpers/airlock/cyclelink_helper_multi{
	cycle_id = "interlinkblaster"
	},
/obj/docking_port/mobile{
	dir = 8;
	shuttle_id = "interlink";
	name = "blaster shuttle";
	preferred_direction = 4
	},
/turf/open/floor/iron/smooth_large,
/area/shuttle/interlink)

(1,1,1) = {"
o
U
M
U
o
"}
(2,1,1) = {"
U
U
Y
U
U
"}
(3,1,1) = {"
v
C
N
K
u
"}
(4,1,1) = {"
U
t
J
R
U
"}
(5,1,1) = {"
U
b
B
S
U
"}
(6,1,1) = {"
z
G
p
k
z
"}
(7,1,1) = {"
z
X
p
F
z
"}
(8,1,1) = {"
z
G
p
L
z
"}
(9,1,1) = {"
U
Q
D
w
U
"}
(10,1,1) = {"
U
c
J
A
U
"}
(11,1,1) = {"
v
H
W
a
u
"}
(12,1,1) = {"
U
U
d
U
U
"}
(13,1,1) = {"
o
U
Z
U
o
"}
