//MAP CONVERTED BY dmm2tgm.py THIS HEADER COMMENT PREVENTS RECONVERSION, DO NOT REMOVE
"aQ" = (
/obj/machinery/rnd/production/circuit_imprinter,
/obj/machinery/light/small/directional/east,
/turf/open/floor/iron,
/area/station/service/broadcast_centre)
"ba" = (
/obj/machinery/atmospherics/pipe/smart/manifold4w/supply/hidden/layer4,
/obj/machinery/atmospherics/pipe/smart/manifold4w/scrubbers/hidden/layer2,
/turf/open/floor/iron/dark,
/area/station/service/broadcast_centre)
"by" = (
/obj/effect/turf_decal/siding/dark{
	dir = 8
	},
/obj/effect/turf_decal/trimline/green/warning{
	dir = 4
	},
/turf/open/floor/iron,
/area/station/service/broadcast_centre)
"cJ" = (
/obj/machinery/airalarm/directional/west,
/obj/machinery/atmospherics/components/unary/vent_scrubber/on/layer2{
	dir = 4
	},
/turf/open/floor/iron/dark,
/area/station/service/broadcast_centre)
"dT" = (
/obj/effect/spawner/liquids_spawner,
/obj/machinery/airalarm/directional/east,
/turf/open/floor/iron/pool,
/area/station/service/broadcast_centre)
"dW" = (
/obj/structure/cable,
/turf/open/floor/iron/dark,
/area/station/service/broadcast_centre)
"ec" = (
/obj/effect/turf_decal/siding/thinplating_new{
	dir = 4
	},
/turf/open/floor/iron/dark/small,
/area/station/service/broadcast_centre)
"ek" = (
/obj/machinery/atmospherics/pipe/smart/manifold4w/supply/hidden/layer4,
/obj/machinery/atmospherics/pipe/smart/manifold4w/scrubbers/hidden/layer2,
/turf/open/floor/catwalk_floor/iron_dark,
/area/station/service/broadcast_centre)
"gd" = (
/obj/structure/chair/stool/bar/directional/west,
/obj/structure/mirror/directional/west,
/obj/effect/landmark/start/broadcast_team,
/turf/open/floor/wood,
/area/station/service/broadcast_centre)
"hp" = (
/obj/effect/turf_decal/trimline/green/warning,
/obj/machinery/atmospherics/pipe/smart/manifold4w/supply/hidden/layer4,
/obj/machinery/atmospherics/pipe/smart/manifold4w/scrubbers/hidden/layer2,
/turf/open/floor/iron/dark,
/area/station/service/broadcast_centre)
"ic" = (
/obj/machinery/door/airlock,
/obj/effect/mapping_helpers/airlock/access/all/service/broadcast_centre,
/obj/effect/mapping_helpers/airlock/autoname,
/obj/structure/cable,
/obj/machinery/atmospherics/pipe/smart/manifold4w/supply/hidden/layer4,
/obj/machinery/atmospherics/pipe/smart/manifold4w/scrubbers/hidden/layer2,
/turf/open/floor/iron/dark/small,
/area/station/service/broadcast_centre)
"kF" = (
/obj/effect/turf_decal/siding/white{
	dir = 4
	},
/obj/structure/toilet{
	dir = 1
	},
/obj/machinery/atmospherics/components/unary/vent_pump/on/layer4{
	dir = 1
	},
/turf/open/floor/iron/freezer,
/area/station/service/broadcast_centre)
"lf" = (
/obj/effect/turf_decal/siding/dark{
	dir = 1
	},
/obj/effect/turf_decal/trimline/green/warning,
/turf/open/floor/iron/dark,
/area/station/service/broadcast_centre)
"lK" = (
/obj/machinery/atmospherics/pipe/smart/manifold4w/supply/hidden/layer4,
/obj/machinery/atmospherics/pipe/smart/manifold4w/scrubbers/hidden/layer2,
/obj/machinery/button/door/directional/east{
	normaldoorcontrol = 1;
	specialfunctions = 4;
	id = "dressingroombolts";
	name = "Bolt Control"
	},
/obj/structure/safe/floor,
/obj/item/vending_refill/lustwish,
/obj/item/stack/cable_coil/five,
/turf/open/floor/wood,
/area/station/service/broadcast_centre)
"lS" = (
/obj/structure/rack,
/obj/machinery/airalarm/directional/south,
/turf/open/floor/wood,
/area/station/service/broadcast_centre)
"lZ" = (
/obj/machinery/light/small/directional/west,
/obj/effect/turf_decal/siding/white{
	dir = 4
	},
/obj/machinery/atmospherics/pipe/smart/manifold4w/supply/hidden/layer4,
/obj/effect/landmark/start/broadcast_team,
/turf/open/floor/iron/freezer,
/area/station/service/broadcast_centre)
"mA" = (
/obj/machinery/computer/camera_advanced/base_construction/broadcast,
/obj/structure/cable,
/obj/machinery/atmospherics/pipe/smart/manifold4w/supply/hidden/layer4,
/turf/open/floor/iron/dark,
/area/station/service/broadcast_centre)
"nx" = (
/obj/structure/table,
/obj/machinery/computer/security/telescreen/broadcast_team{
	dir = 8;
	pixel_y = 3
	},
/obj/machinery/atmospherics/pipe/smart/manifold4w/supply/hidden/layer4,
/turf/open/floor/iron/dark,
/area/station/service/broadcast_centre)
"pf" = (
/turf/open/floor/iron/dark,
/area/station/service/broadcast_centre)
"pM" = (
/obj/effect/landmark/atmospheric_sanity/ignore_area,
/turf/open/floor/iron,
/area/station/service/broadcast_centre/stage)
"qD" = (
/obj/effect/turf_decal/siding/dark{
	dir = 8
	},
/obj/effect/turf_decal/trimline/green/warning{
	dir = 4
	},
/obj/effect/landmark/start/broadcast_team,
/turf/open/floor/iron,
/area/station/service/broadcast_centre)
"tB" = (
/obj/structure/rack,
/obj/effect/turf_decal/siding/dark{
	dir = 8
	},
/obj/effect/turf_decal/trimline/green/warning{
	dir = 4
	},
/obj/effect/spawner/random/engineering/material,
/obj/effect/spawner/random/engineering/material_cheap,
/obj/effect/spawner/random/decoration/generic,
/turf/open/floor/iron,
/area/station/service/broadcast_centre)
"tM" = (
/obj/structure/table,
/obj/machinery/button/showtime/broadcast_team,
/obj/item/reagent_containers/cup/glass/waterbottle{
	pixel_y = 12;
	pixel_x = 8
	},
/obj/structure/cable,
/obj/machinery/atmospherics/pipe/smart/manifold4w/supply/hidden/layer4,
/turf/open/floor/iron/dark,
/area/station/service/broadcast_centre)
"tT" = (
/obj/structure/table,
/obj/machinery/cell_charger,
/obj/item/stack/cable_coil,
/obj/structure/sign/clock/directional/east,
/turf/open/floor/iron,
/area/station/service/broadcast_centre)
"uB" = (
/turf/template_noop,
/area/template_noop)
"uZ" = (
/turf/closed/wall/rock/porous,
/area/station/service/broadcast_centre)
"yK" = (
/obj/machinery/camera/broadcast/directional/north{
	view_range = 4
	},
/turf/open/floor/iron,
/area/station/service/broadcast_centre/stage)
"yZ" = (
/obj/structure/cable,
/obj/effect/turf_decal/siding/thinplating_new{
	dir = 4
	},
/obj/machinery/atmospherics/pipe/smart/manifold4w/supply/hidden/layer4,
/obj/machinery/atmospherics/pipe/smart/manifold4w/scrubbers/hidden/layer2,
/obj/machinery/light_switch/directional/north,
/turf/open/floor/iron/dark/small,
/area/station/service/broadcast_centre)
"CX" = (
/turf/closed/wall,
/area/station/maintenance/central/lesser)
"Ih" = (
/obj/effect/turf_decal/siding/dark{
	dir = 8
	},
/obj/effect/turf_decal/trimline/green/warning{
	dir = 4
	},
/obj/structure/cable,
/obj/machinery/power/apc/auto_name/directional/north,
/turf/open/floor/iron,
/area/station/service/broadcast_centre)
"It" = (
/obj/structure/table,
/obj/item/storage/toolbox/mechanical{
	pixel_y = 10;
	pixel_x = 3
	},
/obj/item/storage/toolbox/mechanical{
	pixel_y = 5;
	pixel_x = 2
	},
/obj/item/multitool{
	pixel_x = -4
	},
/obj/item/multitool{
	pixel_x = 2
	},
/turf/open/floor/iron,
/area/station/service/broadcast_centre)
"Ix" = (
/obj/machinery/power/floodlight,
/obj/structure/cable,
/obj/machinery/atmospherics/pipe/smart/manifold4w/supply/hidden/layer4,
/obj/machinery/atmospherics/pipe/smart/manifold4w/scrubbers/hidden/layer2,
/turf/open/floor/catwalk_floor/iron_dark,
/area/station/service/broadcast_centre)
"JT" = (
/obj/effect/turf_decal/trimline/green/warning,
/turf/open/floor/iron/dark,
/area/station/service/broadcast_centre)
"KL" = (
/obj/machinery/autolathe,
/turf/open/floor/iron,
/area/station/service/broadcast_centre)
"Mh" = (
/obj/effect/turf_decal/trimline/green/warning,
/obj/machinery/light/small/directional/south,
/obj/machinery/atmospherics/pipe/smart/manifold4w/scrubbers/hidden/layer2,
/turf/open/floor/iron/dark,
/area/station/service/broadcast_centre)
"Mv" = (
/obj/machinery/light/small/directional/east,
/obj/machinery/atmospherics/components/unary/vent_pump/on/layer4{
	dir = 1
	},
/turf/open/floor/wood,
/area/station/service/broadcast_centre)
"Ny" = (
/obj/machinery/vending/autodrobe,
/turf/open/floor/iron,
/area/station/service/broadcast_centre)
"OZ" = (
/obj/item/radio/intercom/broadcast/directional/west,
/turf/open/floor/iron,
/area/station/service/broadcast_centre/stage)
"PQ" = (
/obj/structure/dresser,
/turf/open/floor/wood,
/area/station/service/broadcast_centre)
"Qf" = (
/obj/structure/chair/office{
	dir = 1
	},
/obj/effect/landmark/start/broadcast_team,
/turf/open/floor/iron/dark,
/area/station/service/broadcast_centre)
"Qn" = (
/turf/closed/wall,
/area/station/service/broadcast_centre)
"Qz" = (
/obj/machinery/door/airlock/silver{
	name = "Bathroom";
	id_tag = "broadcastbathroom"
	},
/obj/machinery/atmospherics/pipe/smart/manifold4w/supply/hidden/layer4,
/obj/machinery/atmospherics/pipe/smart/manifold4w/scrubbers/hidden/layer2,
/turf/open/floor/iron/dark/textured_large,
/area/station/service/broadcast_centre)
"Rj" = (
/obj/structure/chair/stool/bar/directional/west,
/obj/structure/mirror/directional/west,
/obj/machinery/atmospherics/components/unary/vent_scrubber/on/layer2{
	dir = 4
	},
/obj/effect/landmark/start/broadcast_team,
/turf/open/floor/wood,
/area/station/service/broadcast_centre)
"Sh" = (
/obj/effect/landmark/start/broadcast_team,
/turf/open/floor/iron,
/area/station/service/broadcast_centre/stage)
"Ty" = (
/obj/machinery/vending/clothing,
/obj/structure/sign/calendar/directional/east,
/turf/open/floor/iron,
/area/station/service/broadcast_centre)
"TM" = (
/obj/machinery/atmospherics/pipe/smart/manifold4w/supply/hidden/layer4,
/turf/open/floor/iron/dark,
/area/station/service/broadcast_centre)
"Vo" = (
/obj/structure/cable,
/obj/machinery/atmospherics/pipe/smart/manifold4w/supply/hidden/layer4,
/obj/machinery/atmospherics/pipe/smart/manifold4w/scrubbers/hidden/layer2,
/turf/open/floor/iron/dark,
/area/station/service/broadcast_centre)
"Vu" = (
/obj/effect/turf_decal/siding/wood,
/obj/effect/turf_decal/siding/wood{
	dir = 1
	},
/obj/machinery/door/airlock{
	id_tag = "dressingroombolts";
	name = "Dressing Room"
	},
/obj/machinery/atmospherics/pipe/smart/manifold4w/supply/hidden/layer4,
/obj/machinery/atmospherics/pipe/smart/manifold4w/scrubbers/hidden/layer2,
/obj/effect/mapping_helpers/airlock/access/all/service/broadcast_centre,
/obj/effect/mapping_helpers/airlock/unres,
/turf/open/floor/wood/large,
/area/station/service/broadcast_centre)
"VU" = (
/obj/effect/spawner/liquids_spawner,
/obj/item/bikehorn/rubberducky/plasticducky,
/turf/open/floor/iron/pool,
/area/station/service/broadcast_centre)
"Wh" = (
/turf/open/floor/iron,
/area/station/service/broadcast_centre/stage)
"WB" = (
/obj/effect/turf_decal/siding/dark{
	dir = 1
	},
/obj/effect/turf_decal/trimline/dark/warning,
/obj/machinery/button/door/directional/west{
	normaldoorcontrol = 1;
	specialfunctions = 4;
	id = "broadcastbathroom";
	name = "Bolt Control"
	},
/obj/effect/turf_decal/siding/white/corner,
/obj/structure/sink/directional/west,
/obj/structure/mirror/directional/east,
/obj/machinery/atmospherics/pipe/smart/manifold4w/supply/hidden/layer4,
/obj/machinery/atmospherics/components/unary/vent_scrubber/on/layer2{
	dir = 1
	},
/turf/open/floor/iron/freezer,
/area/station/service/broadcast_centre)
"WO" = (
/obj/effect/turf_decal/siding/dark{
	dir = 8
	},
/obj/effect/turf_decal/trimline/green/warning{
	dir = 4
	},
/obj/structure/cable,
/obj/effect/landmark/start/broadcast_team,
/turf/open/floor/iron,
/area/station/service/broadcast_centre)
"Yq" = (
/obj/effect/turf_decal/siding/dark{
	dir = 8
	},
/obj/effect/turf_decal/trimline/green/warning{
	dir = 4
	},
/obj/machinery/atmospherics/components/unary/vent_pump/on/layer4{
	dir = 8
	},
/turf/open/floor/iron,
/area/station/service/broadcast_centre)
"YB" = (
/obj/item/radio/intercom/broadcast/directional/east,
/turf/open/floor/iron,
/area/station/service/broadcast_centre/stage)
"YF" = (
/obj/machinery/door/airlock,
/obj/effect/mapping_helpers/airlock/access/all/service/broadcast_centre,
/obj/effect/mapping_helpers/airlock/autoname,
/turf/open/floor/iron/dark/small,
/area/station/service/broadcast_centre)

(1,1,1) = {"
uB
uB
uB
uB
uB
uB
Qn
ic
YF
Qn
uB
uB
uB
uB
uB
uB
"}
(2,1,1) = {"
Qn
Qn
Qn
Qn
Qn
Qn
Qn
yZ
ec
Qn
Qn
Qn
Qn
Qn
Qn
CX
"}
(3,1,1) = {"
Qn
pM
Wh
OZ
Wh
Wh
lf
Vo
pf
cJ
JT
Qn
Rj
gd
lS
CX
"}
(4,1,1) = {"
Qn
Wh
Wh
Wh
Sh
Wh
lf
Ix
ek
ba
hp
Vu
lK
Mv
PQ
CX
"}
(5,1,1) = {"
Qn
yK
Sh
Wh
Wh
Wh
lf
mA
Qf
pf
Mh
Qn
Qn
Qn
Qn
CX
"}
(6,1,1) = {"
Qn
Wh
Wh
Wh
Sh
Wh
lf
tM
nx
TM
hp
Qz
WB
lZ
kF
CX
"}
(7,1,1) = {"
Qn
Wh
Wh
YB
Wh
Wh
lf
dW
TM
pf
JT
Qn
Qn
VU
dT
CX
"}
(8,1,1) = {"
Qn
Qn
Qn
Qn
Qn
Qn
Ih
WO
Yq
qD
by
tB
CX
CX
CX
CX
"}
(9,1,1) = {"
uB
uB
uB
uZ
Qn
It
tT
KL
aQ
Ty
Ny
CX
CX
uB
uB
uB
"}
(10,1,1) = {"
uB
uB
uB
uB
Qn
Qn
Qn
Qn
Qn
Qn
Qn
CX
uB
uB
uB
uB
"}
