//MAP CONVERTED BY dmm2tgm.py THIS HEADER COMMENT PREVENTS RECONVERSION, DO NOT REMOVE
"a" = (
/obj/machinery/computer/shuttle/interlink,
/turf/open/floor/iron/dark/side{
	dir = 8
	},
/area/station/hallway/floor3/fore)

(1,1,1) = {"
a
"}
