//MAP CONVERTED BY dmm2tgm.py THIS HEADER COMMENT PREVENTS RECONVERSION, DO NOT REMOVE
"aA" = (
/obj/machinery/computer/camera_advanced/base_construction/broadcast{
	dir = 8
	},
/obj/machinery/atmospherics/pipe/smart/manifold4w/supply/hidden/layer4,
/obj/machinery/atmospherics/pipe/smart/manifold4w/scrubbers/hidden/layer2,
/turf/open/floor/iron/dark,
/area/station/service/studio)
"aI" = (
/obj/machinery/light/small/directional/north,
/obj/effect/turf_decal/trimline/green/warning{
	dir = 1
	},
/turf/open/floor/iron/dark,
/area/station/service/studio)
"aR" = (
/turf/open/floor/iron/dark,
/area/station/service/studio)
"bG" = (
/obj/machinery/computer/security/telescreen/broadcast_team{
	pixel_y = 2
	},
/obj/structure/table,
/turf/open/floor/iron/dark,
/area/station/service/studio)
"ca" = (
/obj/machinery/atmospherics/pipe/smart/manifold4w/supply/hidden/layer4,
/obj/structure/cable,
/obj/machinery/atmospherics/pipe/smart/manifold4w/scrubbers/hidden/layer2,
/turf/open/floor/iron/dark,
/area/station/service/studio)
"di" = (
/obj/machinery/rnd/production/circuit_imprinter,
/obj/machinery/door/firedoor,
/turf/open/floor/plating,
/area/station/service/studio)
"eb" = (
/obj/structure/table/wood,
/turf/open/floor/wood/large,
/area/station/service/studio)
"er" = (
/obj/item/radio/intercom/broadcast/directional/north,
/turf/open/floor/iron,
/area/station/service/studio/stage)
"eB" = (
/obj/machinery/atmospherics/components/unary/vent_scrubber/on/layer2{
	dir = 1
	},
/obj/machinery/light/small/directional/west,
/turf/open/floor/iron/dark,
/area/station/service/studio)
"fa" = (
/obj/effect/landmark/start/broadcast_team,
/turf/open/floor/iron,
/area/station/service/studio/stage)
"fI" = (
/obj/effect/landmark/atmospheric_sanity/ignore_area,
/turf/open/floor/iron,
/area/station/service/studio/stage)
"gx" = (
/turf/closed/wall,
/area/station/service/studio)
"hn" = (
/obj/effect/turf_decal/siding/dark{
	dir = 4
	},
/obj/machinery/atmospherics/pipe/smart/manifold4w/supply/hidden/layer4,
/obj/machinery/atmospherics/pipe/smart/manifold4w/scrubbers/hidden/layer2,
/turf/open/floor/iron/dark,
/area/station/service/studio)
"hH" = (
/obj/structure/mirror/directional/west,
/obj/structure/sink/directional/east,
/obj/machinery/atmospherics/components/unary/passive_vent{
	dir = 1
	},
/turf/open/floor/iron/freezer,
/area/station/service/studio)
"iv" = (
/obj/machinery/door/airlock/hatch{
	name = "Maintenance Hatch"
	},
/obj/effect/mapping_helpers/airlock/access/all/service/studio,
/obj/machinery/atmospherics/pipe/smart/manifold4w/supply/hidden/layer4,
/obj/structure/cable,
/obj/machinery/atmospherics/pipe/smart/manifold4w/scrubbers/hidden/layer2,
/turf/open/floor/plating,
/area/station/service/studio)
"jg" = (
/obj/effect/turf_decal/trimline/green/warning{
	dir = 8
	},
/obj/machinery/atmospherics/pipe/smart/manifold4w/supply/hidden/layer4,
/obj/machinery/firealarm/directional/north,
/turf/open/floor/iron/dark,
/area/station/service/studio)
"jh" = (
/turf/open/floor/wood,
/area/station/service/studio)
"jL" = (
/obj/structure/chair/office{
	dir = 4
	},
/obj/machinery/atmospherics/pipe/smart/manifold4w/supply/hidden/layer4,
/obj/machinery/atmospherics/pipe/smart/manifold4w/scrubbers/hidden/layer2,
/obj/structure/cable,
/obj/effect/landmark/start/broadcast_team,
/turf/open/floor/iron/dark,
/area/station/service/studio)
"kp" = (
/obj/effect/decal/cleanable/dirt,
/obj/structure/table,
/obj/item/clothing/mask/gas,
/turf/open/floor/iron/smooth_large,
/area/station/service/studio)
"kY" = (
/obj/structure/cable,
/obj/machinery/power/apc/auto_name/directional/west,
/turf/open/floor/iron/dark,
/area/station/service/studio)
"ls" = (
/turf/open/floor/catwalk_floor/iron_dark,
/area/station/service/studio)
"lP" = (
/obj/effect/turf_decal/bot_white,
/obj/machinery/atmospherics/components/unary/vent_pump/on/layer4,
/turf/open/floor/wood/large,
/area/station/service/studio)
"lZ" = (
/obj/effect/spawner/random/structure/closet_maintenance,
/turf/open/floor/iron/smooth_large,
/area/station/service/studio)
"md" = (
/obj/structure/cable,
/obj/machinery/atmospherics/pipe/smart/manifold4w/supply/hidden/layer4,
/obj/machinery/atmospherics/pipe/smart/manifold4w/scrubbers/hidden/layer2,
/obj/effect/turf_decal/trimline/green/warning,
/obj/effect/turf_decal/siding/dark{
	dir = 4
	},
/turf/open/floor/iron/dark,
/area/station/service/studio)
"mB" = (
/obj/effect/decal/cleanable/dirt,
/obj/effect/turf_decal/bot_white,
/obj/machinery/power/floodlight,
/turf/open/floor/iron/smooth_large,
/area/station/service/studio)
"nK" = (
/obj/machinery/atmospherics/pipe/smart/manifold4w/supply/hidden/layer4,
/turf/open/floor/wood,
/area/station/service/studio)
"oQ" = (
/obj/structure/toilet{
	dir = 8
	},
/obj/machinery/button/door/directional/north{
	id = "broadcastbathroom";
	name = "Bolt Control";
	normaldoorcontrol = 1;
	specialfunctions = 4
	},
/obj/effect/landmark/start/broadcast_team,
/turf/open/floor/iron/freezer,
/area/station/service/studio)
"oR" = (
/obj/machinery/autolathe,
/obj/machinery/door/firedoor,
/turf/open/floor/plating,
/area/station/service/studio)
"oW" = (
/obj/structure/chair/sofa/bench/right,
/obj/effect/turf_decal/siding/wood,
/turf/open/floor/iron/dark,
/area/station/service/studio)
"po" = (
/obj/effect/landmark/start/broadcast_team,
/turf/open/floor/iron/dark,
/area/station/service/studio)
"pQ" = (
/obj/effect/spawner/structure/window/reinforced,
/turf/open/floor/plating,
/area/station/service/studio)
"qv" = (
/obj/effect/turf_decal/siding/wood{
	dir = 8
	},
/obj/effect/turf_decal/siding/wood{
	dir = 4
	},
/obj/machinery/door/airlock/service/studio,
/obj/effect/mapping_helpers/airlock/autoname,
/turf/open/floor/wood/large,
/area/station/service/studio)
"qH" = (
/obj/machinery/atmospherics/pipe/smart/manifold4w/supply/hidden/layer4,
/obj/structure/cable,
/obj/machinery/atmospherics/pipe/smart/manifold4w/scrubbers/hidden/layer2,
/obj/effect/landmark/start/broadcast_team,
/turf/open/floor/iron/dark,
/area/station/service/studio)
"ry" = (
/obj/machinery/atmospherics/pipe/smart/manifold4w/supply/hidden/layer4,
/obj/machinery/atmospherics/pipe/smart/manifold4w/scrubbers/hidden/layer2,
/turf/open/floor/wood,
/area/station/service/studio)
"rY" = (
/obj/machinery/computer/security/telescreen/entertainment/directional/south,
/obj/structure/table/wood,
/turf/open/floor/wood/large,
/area/station/service/studio)
"sa" = (
/obj/structure/mirror/directional/west,
/obj/structure/chair/stool/directional/west,
/obj/machinery/atmospherics/components/unary/vent_scrubber/on/layer2{
	dir = 4
	},
/obj/machinery/button/door/directional/north{
	id = "dressingroombolts";
	name = "Bolt Control";
	normaldoorcontrol = 1;
	specialfunctions = 4
	},
/obj/effect/landmark/start/broadcast_team,
/turf/open/floor/wood,
/area/station/service/studio)
"sQ" = (
/obj/effect/decal/cleanable/dirt,
/obj/effect/turf_decal/bot_white,
/turf/open/floor/iron/smooth_large,
/area/station/service/studio)
"sY" = (
/obj/structure/table,
/obj/machinery/cell_charger,
/obj/effect/turf_decal/trimline/green/warning{
	dir = 1
	},
/obj/structure/sign/calendar/directional/north,
/turf/open/floor/iron/dark,
/area/station/service/studio)
"tF" = (
/turf/open/floor/wood/large,
/area/station/service/studio)
"uf" = (
/obj/effect/turf_decal/trimline/green/warning,
/turf/open/floor/iron/dark,
/area/station/service/studio)
"uF" = (
/obj/effect/landmark/start/broadcast_team,
/turf/open/floor/catwalk_floor/iron_dark,
/area/station/service/studio)
"uL" = (
/obj/effect/decal/cleanable/dirt,
/obj/effect/turf_decal/bot_white,
/obj/machinery/light/directional/west,
/turf/open/floor/iron/smooth_large,
/area/station/service/studio)
"vo" = (
/obj/structure/table,
/obj/machinery/button/showtime/broadcast_team,
/obj/item/reagent_containers/cup/glass/waterbottle{
	pixel_y = 12;
	pixel_x = 8
	},
/turf/open/floor/iron/dark,
/area/station/service/studio)
"vw" = (
/obj/effect/turf_decal/siding/wood,
/obj/effect/turf_decal/siding/wood{
	dir = 1
	},
/obj/machinery/door/airlock/silver{
	name = "Dressing Room";
	id_tag = "dressingroombolts"
	},
/obj/effect/mapping_helpers/airlock/access/all/service/studio,
/obj/effect/mapping_helpers/airlock/unres,
/obj/machinery/atmospherics/pipe/smart/manifold4w/supply/hidden/layer4,
/obj/machinery/atmospherics/pipe/smart/manifold4w/scrubbers/hidden/layer2,
/turf/open/floor/wood/large,
/area/station/service/studio)
"vS" = (
/obj/structure/rack,
/obj/machinery/atmospherics/components/unary/vent_pump/on/layer4{
	dir = 1
	},
/turf/open/floor/wood,
/area/station/service/studio)
"wl" = (
/turf/open/floor/iron/smooth_large,
/area/station/service/studio)
"xr" = (
/obj/structure/table,
/obj/item/storage/toolbox/mechanical{
	pixel_y = 10;
	pixel_x = 3
	},
/obj/item/storage/toolbox/mechanical{
	pixel_y = 5;
	pixel_x = 2
	},
/obj/item/multitool{
	pixel_x = -4
	},
/obj/item/multitool{
	pixel_x = 2
	},
/obj/machinery/airalarm/directional/north,
/obj/effect/turf_decal/trimline/green/warning{
	dir = 1
	},
/turf/open/floor/iron/dark,
/area/station/service/studio)
"yd" = (
/obj/structure/chair{
	dir = 8
	},
/obj/machinery/atmospherics/pipe/smart/manifold4w/supply/hidden/layer4,
/obj/machinery/atmospherics/pipe/smart/manifold4w/scrubbers/hidden/layer2,
/obj/effect/landmark/start/broadcast_team,
/obj/machinery/light_switch/directional/east,
/turf/open/floor/iron/dark,
/area/station/service/studio)
"yf" = (
/obj/structure/reagent_dispensers/water_cooler,
/turf/open/floor/wood/large,
/area/station/service/studio)
"yr" = (
/obj/machinery/firealarm/directional/south,
/obj/effect/turf_decal/trimline/green/warning,
/turf/open/floor/iron/dark,
/area/station/service/studio)
"AA" = (
/obj/effect/turf_decal/siding/dark/corner,
/obj/structure/chair{
	dir = 8
	},
/obj/structure/railing{
	layer = 3.1
	},
/obj/machinery/atmospherics/pipe/smart/manifold4w/supply/hidden/layer4,
/obj/machinery/atmospherics/pipe/smart/manifold4w/scrubbers/hidden/layer2,
/obj/machinery/camera/autoname/directional/east,
/turf/open/floor/iron/dark,
/area/station/service/studio)
"AM" = (
/obj/effect/turf_decal/siding/wood{
	dir = 8
	},
/obj/effect/turf_decal/siding/wood{
	dir = 4
	},
/obj/machinery/door/airlock/service/studio,
/obj/effect/mapping_helpers/airlock/access/all/service/studio,
/obj/effect/mapping_helpers/airlock/autoname,
/obj/machinery/atmospherics/pipe/smart/manifold4w/supply/hidden/layer4,
/obj/machinery/atmospherics/pipe/smart/manifold4w/scrubbers/hidden/layer2,
/obj/effect/landmark/navigate_destination,
/turf/open/floor/wood/large,
/area/station/service/studio)
"AX" = (
/obj/effect/turf_decal/trimline/green/corner{
	dir = 1
	},
/obj/machinery/atmospherics/pipe/smart/manifold4w/supply/hidden/layer4,
/obj/machinery/atmospherics/pipe/smart/manifold4w/scrubbers/hidden/layer2,
/turf/open/floor/iron/dark,
/area/station/service/studio)
"Dc" = (
/obj/item/radio/intercom/broadcast/directional/south,
/turf/open/floor/iron,
/area/station/service/studio/stage)
"Fd" = (
/obj/effect/turf_decal/siding/dark/corner,
/turf/closed/wall,
/area/station/service/studio)
"Fy" = (
/obj/effect/decal/cleanable/dirt,
/obj/structure/table,
/obj/machinery/camera/autoname/directional/north,
/obj/machinery/cell_charger,
/obj/item/stack/cable_coil,
/turf/open/floor/iron/smooth_large,
/area/station/service/studio)
"FT" = (
/obj/effect/turf_decal/stripes/line{
	dir = 4
	},
/obj/machinery/door/poddoor/shutters{
	id = "warehousebroadcast";
	dir = 4
	},
/obj/machinery/atmospherics/pipe/smart/manifold4w/scrubbers/hidden/layer2,
/turf/open/floor/iron/smooth_half{
	dir = 1
	},
/area/station/service/studio)
"FW" = (
/obj/machinery/door/airlock/service/studio,
/obj/effect/mapping_helpers/airlock/access/all/service/studio,
/obj/effect/mapping_helpers/airlock/autoname,
/obj/machinery/atmospherics/pipe/smart/manifold4w/supply/hidden/layer4,
/obj/machinery/atmospherics/pipe/smart/manifold4w/scrubbers/hidden/layer2,
/obj/structure/cable,
/turf/open/floor/iron/dark,
/area/station/service/studio)
"Ge" = (
/obj/machinery/light/directional/south,
/obj/structure/table/wood,
/obj/item/paper_bin{
	pixel_y = 4
	},
/obj/item/pen,
/turf/open/floor/wood/large,
/area/station/service/studio)
"Gy" = (
/obj/machinery/power/floodlight,
/obj/structure/cable,
/turf/open/floor/catwalk_floor/iron_dark,
/area/station/service/studio)
"HB" = (
/obj/effect/turf_decal/trimline/green/warning{
	dir = 8
	},
/obj/machinery/atmospherics/pipe/smart/manifold4w/supply/hidden/layer4,
/obj/machinery/atmospherics/pipe/smart/manifold4w/scrubbers/hidden/layer2,
/turf/open/floor/iron/dark,
/area/station/service/studio)
"Iq" = (
/obj/structure/cable,
/turf/open/floor/catwalk_floor/iron_dark,
/area/station/service/studio)
"LQ" = (
/obj/effect/turf_decal/trimline/green/warning,
/obj/structure/sign/clock/directional/west,
/turf/open/floor/iron/dark,
/area/station/service/studio)
"MN" = (
/obj/effect/decal/cleanable/dirt,
/obj/machinery/atmospherics/components/unary/vent_scrubber/on/layer2{
	dir = 4
	},
/turf/open/floor/iron/smooth_large,
/area/station/service/studio)
"MW" = (
/obj/effect/decal/cleanable/dirt,
/obj/structure/rack,
/obj/item/chair/plastic,
/obj/item/chair/plastic{
	pixel_y = 4
	},
/obj/item/chair/plastic{
	pixel_y = 8
	},
/obj/item/chair/plastic{
	pixel_y = 12
	},
/obj/item/chair/plastic{
	pixel_y = 14
	},
/turf/open/floor/iron/smooth_large,
/area/station/service/studio)
"Nn" = (
/obj/structure/rack,
/obj/effect/spawner/random/decoration/material,
/obj/effect/spawner/random/engineering/material,
/obj/effect/spawner/random/decoration/generic,
/turf/open/floor/iron/dark/textured_large,
/area/station/service/studio)
"Nz" = (
/turf/open/floor/iron,
/area/station/service/studio/stage)
"NK" = (
/obj/effect/decal/cleanable/dirt,
/obj/machinery/atmospherics/pipe/smart/manifold4w/supply/hidden/layer4,
/turf/open/floor/iron/smooth_large,
/area/station/service/studio)
"Oo" = (
/obj/machinery/atmospherics/components/unary/vent_scrubber/on/layer2{
	dir = 1
	},
/turf/open/floor/wood/large,
/area/station/service/studio)
"Ot" = (
/obj/machinery/atmospherics/pipe/smart/manifold4w/supply/hidden/layer4,
/obj/effect/landmark/start/broadcast_team,
/turf/open/floor/iron/smooth_large,
/area/station/service/studio)
"Pw" = (
/obj/effect/decal/cleanable/dirt,
/obj/machinery/atmospherics/components/unary/vent_pump/on/layer4,
/turf/open/floor/iron/smooth_large,
/area/station/service/studio)
"Px" = (
/obj/machinery/atmospherics/pipe/smart/manifold4w/supply/hidden/layer4,
/obj/structure/cable,
/obj/machinery/atmospherics/pipe/smart/manifold4w/scrubbers/hidden/layer2,
/obj/effect/turf_decal/trimline/green/warning{
	dir = 1
	},
/turf/open/floor/iron/dark,
/area/station/service/studio)
"Qb" = (
/obj/machinery/atmospherics/pipe/smart/manifold4w/supply/hidden/layer4,
/obj/machinery/atmospherics/pipe/smart/manifold4w/scrubbers/hidden/layer2,
/obj/structure/cable,
/obj/machinery/atmospherics/components/unary/passive_vent,
/turf/open/floor/iron/dark,
/area/station/service/studio)
"QX" = (
/obj/effect/turf_decal/siding/dark{
	dir = 4
	},
/obj/structure/cable,
/obj/machinery/atmospherics/pipe/smart/manifold4w/supply/hidden/layer4,
/obj/machinery/atmospherics/pipe/smart/manifold4w/scrubbers/hidden/layer2,
/turf/open/floor/iron/dark,
/area/station/service/studio)
"Rs" = (
/obj/machinery/vending/clothing,
/obj/structure/railing{
	dir = 8
	},
/turf/open/floor/iron/dark/textured_large,
/area/station/service/studio)
"SF" = (
/obj/effect/turf_decal/trimline/green/warning{
	dir = 1
	},
/obj/machinery/atmospherics/pipe/smart/manifold4w/supply/hidden/layer4,
/obj/machinery/atmospherics/pipe/smart/manifold4w/scrubbers/hidden/layer2,
/turf/open/floor/iron/dark,
/area/station/service/studio)
"SM" = (
/obj/machinery/door/airlock/hatch{
	name = "Maintenance Hatch"
	},
/obj/effect/mapping_helpers/airlock/access/all/service/studio,
/obj/effect/turf_decal/stripes/line{
	dir = 1
	},
/obj/structure/cable,
/obj/machinery/atmospherics/pipe/smart/manifold4w/supply/hidden/layer4,
/obj/machinery/atmospherics/pipe/smart/manifold4w/scrubbers/hidden/layer2,
/turf/open/floor/plating,
/area/station/service/studio)
"Th" = (
/obj/effect/turf_decal/siding/dark{
	dir = 1
	},
/obj/machinery/door/airlock/silver{
	name = "Bathroom";
	id_tag = "broadcastbathroom"
	},
/obj/machinery/atmospherics/pipe/smart/simple/cyan/hidden,
/turf/open/floor/iron/freezer,
/area/station/service/studio)
"Tq" = (
/obj/structure/dresser,
/obj/machinery/light/small/directional/west,
/turf/open/floor/wood,
/area/station/service/studio)
"Ty" = (
/obj/machinery/atmospherics/components/unary/vent_pump/on/layer4{
	dir = 4
	},
/turf/open/floor/iron/dark,
/area/station/service/studio)
"TQ" = (
/obj/machinery/vending/autodrobe,
/obj/structure/railing{
	dir = 8
	},
/turf/open/floor/iron/dark/textured_large,
/area/station/service/studio)
"Vr" = (
/obj/machinery/shower/directional/north,
/obj/structure/curtain,
/obj/structure/drain,
/obj/machinery/light/small/directional/east,
/turf/open/floor/iron/freezer,
/area/station/service/studio)
"Vw" = (
/obj/effect/turf_decal/bot_white,
/obj/structure/frame/machine,
/turf/open/floor/iron/smooth_large,
/area/station/service/studio)
"VN" = (
/obj/machinery/atmospherics/pipe/smart/manifold4w/supply/hidden/layer4,
/obj/structure/cable,
/obj/machinery/atmospherics/pipe/smart/manifold4w/scrubbers/hidden/layer2,
/obj/machinery/camera/autoname/directional/south,
/turf/open/floor/iron/dark,
/area/station/service/studio)
"VR" = (
/obj/machinery/camera/broadcast/directional/east{
	view_range = 4
	},
/turf/open/floor/iron,
/area/station/service/studio/stage)
"VU" = (
/obj/effect/turf_decal/stripes/line{
	dir = 4
	},
/obj/machinery/door/poddoor/shutters{
	id = "warehousebroadcast";
	dir = 4
	},
/obj/machinery/button/door/directional/north{
	id = "warehousebroadcast"
	},
/obj/machinery/atmospherics/pipe/smart/manifold4w/supply/hidden/layer4,
/turf/open/floor/iron/smooth_half{
	dir = 1
	},
/area/station/service/studio)
"VW" = (
/obj/structure/closet/crate,
/obj/item/vending_refill/lustwish,
/turf/open/floor/plating,
/area/station/service/studio)
"Wy" = (
/turf/template_noop,
/area/template_noop)
"Xa" = (
/obj/structure/table,
/obj/item/reagent_containers/cup/glass/colocup{
	pixel_y = 10;
	pixel_x = 4
	},
/obj/item/reagent_containers/cup/glass/colocup{
	pixel_y = 3;
	pixel_x = -5
	},
/obj/item/reagent_containers/cup/glass/colocup{
	pixel_y = 1;
	pixel_x = 6
	},
/turf/open/floor/iron/smooth_large,
/area/station/service/studio)
"Xx" = (
/obj/machinery/atmospherics/pipe/smart/manifold4w/supply/hidden/layer4,
/obj/machinery/atmospherics/pipe/smart/manifold4w/scrubbers/hidden/layer2,
/obj/structure/cable,
/turf/open/floor/iron/dark,
/area/station/service/studio)
"Xz" = (
/obj/structure/chair/sofa/bench/left,
/obj/effect/turf_decal/siding/wood{
	dir = 6
	},
/obj/machinery/airalarm/directional/north,
/obj/effect/landmark/start/broadcast_team,
/turf/open/floor/iron/dark,
/area/station/service/studio)
"XF" = (
/obj/structure/table,
/obj/item/airlock_painter/decal/tile{
	pixel_y = 6
	},
/obj/item/airlock_painter/decal{
	pixel_y = 1
	},
/turf/open/floor/iron/dark,
/area/station/service/studio)
"YZ" = (
/obj/structure/rack,
/obj/effect/spawner/random/engineering/material_cheap,
/obj/effect/spawner/random/decoration/material,
/obj/effect/spawner/random/decoration/generic,
/obj/effect/spawner/random/decoration/paint,
/obj/machinery/light/small/directional/north,
/turf/open/floor/iron/dark/textured_large,
/area/station/service/studio)

(1,1,1) = {"
gx
gx
gx
gx
gx
gx
gx
gx
Wy
Wy
Wy
Wy
Wy
Wy
"}
(2,1,1) = {"
gx
Fy
wl
uL
sQ
mB
Vw
gx
iv
gx
gx
gx
gx
gx
"}
(3,1,1) = {"
gx
kp
Pw
NK
Ot
NK
MN
gx
Px
qH
gx
sa
Tq
gx
"}
(4,1,1) = {"
gx
Xa
MW
lZ
gx
VU
FT
gx
aI
ca
vw
ry
vS
gx
"}
(5,1,1) = {"
gx
gx
gx
gx
gx
jg
HB
HB
AX
VN
gx
gx
gx
gx
"}
(6,1,1) = {"
Wy
gx
VW
gx
YZ
aR
Rs
TQ
aR
Qb
Th
hH
Vr
gx
"}
(7,1,1) = {"
Wy
gx
gx
gx
Nn
aR
uF
ls
aR
Xx
gx
oQ
gx
gx
"}
(8,1,1) = {"
Wy
Wy
Wy
gx
gx
gx
oR
di
gx
FW
gx
gx
gx
Wy
"}
(9,1,1) = {"
Wy
Wy
Wy
gx
xr
XF
aR
aR
kY
Xx
eB
LQ
gx
Wy
"}
(10,1,1) = {"
Wy
Wy
Wy
gx
sY
aR
po
aR
bG
jL
Iq
yr
gx
Wy
"}
(11,1,1) = {"
Wy
Wy
Wy
gx
aI
Ty
aR
aR
vo
aA
Gy
uf
gx
Wy
"}
(12,1,1) = {"
Wy
Wy
Wy
gx
SF
yd
AA
hn
hn
hn
QX
md
SM
Wy
"}
(13,1,1) = {"
Wy
Wy
gx
gx
AM
gx
Fd
fI
Nz
Nz
Nz
Nz
gx
Wy
"}
(14,1,1) = {"
Wy
Wy
gx
oW
ry
Oo
gx
Nz
Nz
Nz
fa
Nz
gx
Wy
"}
(15,1,1) = {"
Wy
Wy
gx
Xz
nK
Ge
gx
er
fa
Nz
Nz
Dc
gx
Wy
"}
(16,1,1) = {"
gx
gx
gx
lP
nK
rY
gx
Nz
Nz
Nz
fa
Nz
gx
Wy
"}
(17,1,1) = {"
gx
yf
jh
tF
jh
eb
gx
Nz
Nz
VR
Nz
Nz
gx
Wy
"}
(18,1,1) = {"
gx
gx
qv
pQ
qv
gx
gx
gx
gx
gx
gx
gx
gx
Wy
"}
