//MAP CONVERTED BY dmm2tgm.py THIS HEADER COMMENT PREVENTS RECONVERSION, DO NOT REMOVE
"a" = (
/turf/template_noop,
/area/template_noop)
"b" = (
/turf/open/floor/catwalk_floor,
/area/template_noop)
"c" = (
/obj/effect/turf_decal/siding/dark{
	dir = 9
	},
/obj/effect/turf_decal/siding/wideplating_new,
/turf/open/floor/iron/small,
/area/template_noop)
"d" = (
/turf/closed/wall/mineral/plastitanium/nodiagonal,
/area/template_noop)
"e" = (
/obj/structure/toilet{
	pixel_y = 12
	},
/obj/effect/turf_decal/siding/dark{
	dir = 4
	},
/turf/open/floor/iron/smooth_large,
/area/template_noop)
"f" = (
/obj/effect/turf_decal/siding/wideplating_new,
/obj/effect/turf_decal/siding/dark{
	dir = 1
	},
/turf/open/floor/iron/small,
/area/template_noop)
"g" = (
/obj/effect/turf_decal/siding/wideplating_new{
	dir = 1
	},
/obj/machinery/door/window/survival_pod/left/directional/north,
/obj/structure/bed/maint,
/turf/open/floor/iron/smooth_large,
/area/template_noop)
"h" = (
/obj/structure/closet/crate/bin{
	name = "Toss"
	},
/obj/item/clothing/under/misc/skyrat/gear_harness,
/obj/item/clothing/mask/facehugger/toy,
/turf/open/floor/iron/dark/side{
	dir = 9
	},
/area/template_noop)
"i" = (
/obj/structure/chair/plastic{
	dir = 1
	},
/turf/open/floor/iron/diagonal,
/area/template_noop)
"j" = (
/obj/effect/turf_decal/siding/dark{
	dir = 10
	},
/obj/effect/turf_decal/siding/wideplating_new{
	dir = 1
	},
/turf/open/floor/iron/small,
/area/template_noop)
"k" = (
/turf/open/floor/iron/textured,
/area/template_noop)
"m" = (
/obj/structure/table,
/turf/open/floor/iron/diagonal,
/area/template_noop)
"n" = (
/obj/structure/table,
/obj/item/clothing/under/plasmaman/head_of_personnel{
	pixel_y = 5;
	pixel_x = 7
	},
/obj/item/clothing/under/rank/civilian/chaplain/skirt{
	pixel_y = 7;
	pixel_x = -4
	},
/obj/item/clothing/under/costume/bunnylewd,
/turf/open/floor/iron/diagonal,
/area/template_noop)
"o" = (
/obj/effect/turf_decal/siding/wideplating_new,
/obj/machinery/door/window/survival_pod/left/directional/south,
/obj/structure/bed/maint,
/turf/open/floor/iron/smooth_large,
/area/template_noop)
"p" = (
/obj/effect/turf_decal/siding/wideplating_new{
	dir = 8
	},
/turf/open/floor/iron/dark,
/area/template_noop)
"q" = (
/obj/structure/closet/crate/trashcart/laundry{
	name = "Keep"
	},
/obj/item/clothing/under/syndicate/skyrat/tactical/skirt,
/obj/item/clothing/glasses/regular/betterunshit,
/obj/item/clothing/shoes/colorable_sandals,
/obj/effect/spawner/random/clothing/otherwise_unused,
/obj/effect/spawner/random/clothing/twentyfive_percent_cyborg_mask,
/obj/item/clothing/under/rank/prisoner/skirt/syndicate,
/turf/open/floor/iron/dark,
/area/template_noop)
"r" = (
/obj/item/kirbyplants/random/dead,
/turf/open/floor/iron/diagonal,
/area/template_noop)
"s" = (
/obj/machinery/shower/directional/east,
/turf/open/floor/catwalk_floor,
/area/template_noop)
"t" = (
/obj/effect/turf_decal/siding/dark{
	dir = 8
	},
/turf/open/floor/iron/smooth_large,
/area/template_noop)
"u" = (
/obj/structure/toilet{
	dir = 4
	},
/obj/effect/turf_decal/siding/dark{
	dir = 1
	},
/turf/open/floor/iron/smooth_large,
/area/template_noop)
"v" = (
/obj/structure/toilet{
	pixel_y = 12
	},
/obj/effect/turf_decal/siding/dark{
	dir = 8
	},
/turf/open/floor/iron/smooth_large,
/area/template_noop)
"x" = (
/obj/effect/turf_decal/siding/dark{
	dir = 6
	},
/obj/effect/turf_decal/siding/wideplating_new{
	dir = 1
	},
/turf/open/floor/iron/small,
/area/template_noop)
"y" = (
/obj/structure/table,
/obj/item/clothing/under/chameleon/broken,
/turf/open/floor/iron/diagonal,
/area/template_noop)
"z" = (
/obj/effect/turf_decal/siding/dark{
	dir = 5
	},
/obj/effect/turf_decal/siding/wideplating_new,
/turf/open/floor/iron/small,
/area/template_noop)
"A" = (
/obj/effect/turf_decal/siding/wideplating_new{
	dir = 1
	},
/turf/closed/wall/mineral/plastitanium/nodiagonal,
/area/template_noop)
"B" = (
/obj/structure/rack,
/obj/item/clothing/under/dress/skyrat/pinktutu,
/turf/open/floor/iron/diagonal,
/area/template_noop)
"C" = (
/obj/effect/turf_decal/siding/wideplating_new,
/obj/effect/turf_decal/siding/wideplating_new{
	dir = 1
	},
/obj/machinery/door/airlock/hatch,
/turf/open/floor/iron/smooth_large,
/area/template_noop)
"D" = (
/obj/effect/turf_decal/siding/wideplating_new{
	dir = 8
	},
/obj/effect/turf_decal/siding/wideplating_new{
	dir = 4
	},
/obj/machinery/door/airlock/hatch,
/turf/open/floor/iron/smooth_large,
/area/template_noop)
"E" = (
/obj/effect/turf_decal/siding/wideplating_new{
	dir = 1
	},
/obj/machinery/door/window/survival_pod/left/directional/north,
/obj/structure/bed/maint,
/obj/effect/turf_decal/siding/dark/corner,
/turf/open/floor/iron/smooth_large,
/area/template_noop)
"F" = (
/obj/effect/turf_decal/siding/wideplating_new{
	dir = 1
	},
/obj/effect/turf_decal/siding/dark,
/turf/open/floor/iron/small,
/area/template_noop)
"G" = (
/obj/effect/turf_decal/siding/dark{
	dir = 4
	},
/turf/open/floor/iron/smooth_large,
/area/template_noop)
"H" = (
/obj/machinery/shower/directional/north,
/turf/open/floor/catwalk_floor,
/area/template_noop)
"I" = (
/obj/structure/closet/crate/preopen{
	name = "Sell"
	},
/obj/effect/turf_decal/siding/wideplating_new{
	dir = 8
	},
/obj/item/clothing/under/rank/captain/skyrat/pilot/skirt,
/obj/effect/spawner/random/clothing/otherwise_unused,
/turf/open/floor/iron/dark,
/area/template_noop)
"K" = (
/obj/effect/turf_decal/siding/wideplating_new{
	dir = 1
	},
/obj/machinery/door/window/survival_pod/left/directional/north,
/obj/structure/bed/maint,
/obj/effect/turf_decal/siding/dark/corner{
	dir = 8
	},
/turf/open/floor/iron/smooth_large,
/area/template_noop)
"L" = (
/turf/open/floor/iron/diagonal,
/area/template_noop)
"M" = (
/obj/effect/spawner/structure/window/reinforced/plasma/plastitanium,
/turf/open/floor/plating,
/area/template_noop)
"N" = (
/obj/structure/mannequin{
	dir = 8
	},
/obj/effect/turf_decal/siding/wideplating_new{
	dir = 8
	},
/turf/open/floor/iron/dark/textured_large,
/area/template_noop)
"Q" = (
/obj/structure/toilet{
	dir = 4
	},
/obj/effect/turf_decal/siding/dark,
/turf/open/floor/iron/smooth_large,
/area/template_noop)
"S" = (
/obj/structure/mannequin{
	dir = 8
	},
/obj/effect/turf_decal/siding/wideplating_new{
	dir = 9
	},
/turf/open/floor/iron/dark/textured_large,
/area/template_noop)
"T" = (
/obj/effect/turf_decal/siding/wideplating_new,
/obj/machinery/door/window/survival_pod/left/directional/south,
/obj/structure/bed/maint,
/obj/effect/turf_decal/siding/dark/corner{
	dir = 4
	},
/turf/open/floor/iron/smooth_large,
/area/template_noop)
"U" = (
/obj/effect/turf_decal/siding/wideplating_new,
/obj/machinery/door/window/survival_pod/left/directional/south,
/obj/structure/bed/maint,
/obj/effect/turf_decal/siding/dark/corner{
	dir = 1
	},
/turf/open/floor/iron/smooth_large,
/area/template_noop)
"V" = (
/obj/machinery/shower/directional/south,
/turf/open/floor/catwalk_floor,
/area/template_noop)
"W" = (
/turf/open/floor/iron/dark/side{
	dir = 9
	},
/area/template_noop)
"X" = (
/obj/structure/table,
/obj/item/clothing/under/rank/security/skyrat/utility/redsec{
	pixel_y = 9;
	pixel_x = -6
	},
/obj/item/clothing/under/rank/civilian/clown/sexy,
/turf/open/floor/iron/diagonal,
/area/template_noop)
"Y" = (
/obj/machinery/shower/directional/west,
/turf/open/floor/catwalk_floor,
/area/template_noop)

(1,1,1) = {"
a
a
a
a
a
a
a
a
a
a
a
a
a
a
a
a
a
a
a
a
a
a
a
a
a
a
a
a
a
a
a
a
a
a
a
a
a
a
a
a
a
a
a
a
a
a
a
a
a
a
"}
(2,1,1) = {"
a
a
a
a
a
a
a
a
a
a
a
a
a
a
a
a
a
a
a
a
a
a
a
a
a
a
a
a
a
a
a
a
a
a
a
a
a
a
a
a
a
a
a
a
a
a
a
a
a
a
"}
(3,1,1) = {"
a
a
a
a
a
a
a
a
a
a
a
a
a
a
a
a
a
a
a
a
a
a
a
a
a
a
a
a
a
a
a
a
a
a
a
a
a
a
a
a
a
a
a
a
a
a
a
a
a
a
"}
(4,1,1) = {"
a
a
a
a
a
a
a
a
a
a
a
a
a
a
a
a
a
a
a
a
a
a
a
a
a
a
a
a
a
a
a
a
a
a
a
a
a
a
a
a
a
a
a
a
a
a
a
a
a
a
"}
(5,1,1) = {"
a
a
a
a
a
a
a
a
a
a
a
a
a
a
a
a
a
a
a
a
a
a
a
a
a
a
a
a
a
a
a
a
a
a
a
a
a
a
a
a
a
a
a
a
a
a
a
a
a
a
"}
(6,1,1) = {"
a
a
a
a
a
a
a
a
a
a
a
a
a
a
a
a
a
a
a
a
a
a
a
a
a
a
a
a
a
a
a
a
a
a
a
a
a
a
a
a
a
a
a
a
a
a
a
a
a
a
"}
(7,1,1) = {"
a
a
a
a
a
a
a
a
a
a
a
a
a
a
a
a
a
a
a
a
a
a
a
a
a
a
a
a
a
a
a
a
a
a
a
a
a
a
a
a
a
a
a
a
a
a
a
a
a
a
"}
(8,1,1) = {"
a
a
a
a
a
a
a
a
a
a
a
a
a
a
a
a
a
a
a
a
a
a
a
a
a
a
a
a
a
a
a
a
a
a
a
a
a
a
a
a
a
a
a
a
a
a
a
a
a
a
"}
(9,1,1) = {"
a
a
a
a
a
a
a
a
a
a
a
a
a
a
a
a
a
a
a
a
a
a
a
a
a
a
a
a
a
a
a
a
a
a
a
a
a
a
a
a
a
a
a
a
a
a
a
a
a
a
"}
(10,1,1) = {"
a
a
a
a
a
a
a
a
a
a
a
a
a
a
a
a
a
a
a
a
a
a
a
a
a
a
a
a
a
a
a
a
a
a
a
a
a
a
a
a
a
a
a
a
a
a
a
a
a
a
"}
(11,1,1) = {"
a
a
a
a
a
a
a
a
a
a
a
a
a
a
a
a
a
a
a
a
a
a
a
a
a
a
a
a
a
a
a
a
a
a
a
a
a
a
a
a
a
a
a
a
a
a
a
a
a
a
"}
(12,1,1) = {"
a
a
a
a
a
a
a
a
a
a
a
a
a
a
a
a
a
a
a
a
a
a
a
a
a
a
a
a
a
a
a
a
a
a
a
a
a
a
a
a
a
a
a
a
a
a
a
a
a
a
"}
(13,1,1) = {"
a
a
a
a
a
a
a
a
a
a
a
a
a
a
a
a
a
a
a
a
a
a
a
a
a
a
a
a
a
a
a
a
a
a
a
a
a
a
a
a
a
a
a
a
a
a
a
a
a
a
"}
(14,1,1) = {"
a
a
a
a
a
a
a
a
a
a
a
a
a
a
a
a
a
a
a
a
a
a
a
a
a
a
a
a
a
a
a
a
a
a
a
a
a
a
a
a
a
a
a
a
a
a
a
a
a
a
"}
(15,1,1) = {"
a
a
a
a
a
a
a
a
a
a
a
a
a
a
a
a
a
a
a
a
a
a
a
a
a
a
a
a
a
a
a
a
a
a
a
a
a
a
a
a
a
a
a
a
a
a
a
a
a
a
"}
(16,1,1) = {"
a
a
a
a
a
a
a
a
a
a
a
a
a
a
a
a
a
a
a
a
a
a
a
a
a
a
a
a
a
a
a
a
a
a
a
a
a
a
a
a
a
a
a
a
a
a
a
a
a
a
"}
(17,1,1) = {"
a
a
a
a
a
a
a
a
a
a
a
a
a
a
a
a
a
a
a
a
a
a
a
a
a
a
a
a
a
a
a
a
a
a
a
a
a
a
a
a
a
a
a
a
a
a
a
a
a
a
"}
(18,1,1) = {"
a
a
a
a
a
a
a
a
a
a
a
a
a
d
d
d
d
d
d
d
d
a
d
d
d
d
d
d
d
d
a
a
a
a
a
a
a
a
a
a
a
a
a
a
a
a
a
a
a
a
"}
(19,1,1) = {"
a
a
a
a
a
a
a
a
a
a
a
a
a
d
X
y
B
L
L
L
d
a
d
a
a
a
a
a
a
d
a
a
a
a
a
a
a
a
a
a
a
a
a
a
a
a
a
a
a
a
"}
(20,1,1) = {"
a
a
a
a
a
a
a
a
a
a
a
a
a
M
m
i
L
L
L
L
C
a
C
a
a
a
a
a
a
M
a
a
a
a
a
a
a
a
a
a
a
a
a
a
a
a
a
a
a
a
"}
(21,1,1) = {"
a
a
a
a
a
a
a
a
a
a
a
a
a
d
n
L
L
r
S
N
d
a
d
a
a
a
a
a
a
d
a
a
a
a
a
a
a
a
a
a
a
a
a
a
a
a
a
a
a
a
"}
(22,1,1) = {"
a
a
a
a
a
a
a
a
a
a
a
a
a
d
d
I
p
d
d
d
d
D
d
d
d
d
a
a
d
d
a
a
a
a
a
a
a
a
a
a
a
a
a
a
a
a
a
a
a
a
"}
(23,1,1) = {"
a
a
a
a
a
a
a
a
a
a
a
a
a
a
M
q
W
d
s
d
c
b
j
d
s
d
a
a
M
a
a
a
a
a
a
a
a
a
a
a
a
a
a
a
a
a
a
a
a
a
"}
(24,1,1) = {"
a
a
a
a
a
a
a
a
a
a
a
a
a
a
d
d
h
d
v
U
f
k
F
K
t
d
a
d
d
a
a
a
a
a
a
a
a
a
a
a
a
a
a
a
a
a
a
a
a
a
"}
(25,1,1) = {"
a
a
a
a
a
a
a
a
a
a
a
a
a
a
a
d
d
d
d
d
f
b
F
A
d
d
d
d
a
a
a
a
a
a
a
a
a
a
a
a
a
a
a
a
a
a
a
a
a
a
"}
(26,1,1) = {"
a
a
a
a
a
a
a
a
a
a
a
a
a
a
a
a
d
V
u
o
f
k
F
g
Q
H
d
a
a
a
a
a
a
a
a
a
a
a
a
a
a
a
a
a
a
a
a
a
a
a
"}
(27,1,1) = {"
a
a
a
a
a
a
a
a
a
a
a
a
a
a
a
a
d
d
d
d
f
b
F
d
d
d
d
a
a
a
a
a
a
a
a
a
a
a
a
a
a
a
a
a
a
a
a
a
a
a
"}
(28,1,1) = {"
a
a
a
a
a
a
a
a
a
a
a
a
a
a
a
a
a
d
e
T
f
k
F
E
G
d
a
a
a
a
a
a
a
a
a
a
a
a
a
a
a
a
a
a
a
a
a
a
a
a
"}
(29,1,1) = {"
a
a
a
a
a
a
a
a
a
a
a
a
a
a
a
a
a
d
Y
d
z
b
x
d
Y
d
a
a
a
a
a
a
a
a
a
a
a
a
a
a
a
a
a
a
a
a
a
a
a
a
"}
(30,1,1) = {"
a
a
a
a
a
a
a
a
a
a
a
a
a
a
a
a
a
d
d
d
d
D
d
d
d
d
a
a
a
a
a
a
a
a
a
a
a
a
a
a
a
a
a
a
a
a
a
a
a
a
"}
(31,1,1) = {"
a
a
a
a
a
a
a
a
a
a
a
a
a
a
a
a
a
a
a
a
a
a
a
a
a
a
a
a
a
a
a
a
a
a
a
a
a
a
a
a
a
a
a
a
a
a
a
a
a
a
"}
(32,1,1) = {"
a
a
a
a
a
a
a
a
a
a
a
a
a
a
a
a
a
a
a
a
a
a
a
a
a
a
a
a
a
a
a
a
a
a
a
a
a
a
a
a
a
a
a
a
a
a
a
a
a
a
"}
(33,1,1) = {"
a
a
a
a
a
a
a
a
a
a
a
a
a
a
a
a
a
a
a
a
a
a
a
a
a
a
a
a
a
a
a
a
a
a
a
a
a
a
a
a
a
a
a
a
a
a
a
a
a
a
"}
(34,1,1) = {"
a
a
a
a
a
a
a
a
a
a
a
a
a
a
a
a
a
a
a
a
a
a
a
a
a
a
a
a
a
a
a
a
a
a
a
a
a
a
a
a
a
a
a
a
a
a
a
a
a
a
"}
(35,1,1) = {"
a
a
a
a
a
a
a
a
a
a
a
a
a
a
a
a
a
a
a
a
a
a
a
a
a
a
a
a
a
a
a
a
a
a
a
a
a
a
a
a
a
a
a
a
a
a
a
a
a
a
"}
(36,1,1) = {"
a
a
a
a
a
a
a
a
a
a
a
a
a
a
a
a
a
a
a
a
a
a
a
a
a
a
a
a
a
a
a
a
a
a
a
a
a
a
a
a
a
a
a
a
a
a
a
a
a
a
"}
(37,1,1) = {"
a
a
a
a
a
a
a
a
a
a
a
a
a
a
a
a
a
a
a
a
a
a
a
a
a
a
a
a
a
a
a
a
a
a
a
a
a
a
a
a
a
a
a
a
a
a
a
a
a
a
"}
(38,1,1) = {"
a
a
a
a
a
a
a
a
a
a
a
a
a
a
a
a
a
a
a
a
a
a
a
a
a
a
a
a
a
a
a
a
a
a
a
a
a
a
a
a
a
a
a
a
a
a
a
a
a
a
"}
(39,1,1) = {"
a
a
a
a
a
a
a
a
a
a
a
a
a
a
a
a
a
a
a
a
a
a
a
a
a
a
a
a
a
a
a
a
a
a
a
a
a
a
a
a
a
a
a
a
a
a
a
a
a
a
"}
(40,1,1) = {"
a
a
a
a
a
a
a
a
a
a
a
a
a
a
a
a
a
a
a
a
a
a
a
a
a
a
a
a
a
a
a
a
a
a
a
a
a
a
a
a
a
a
a
a
a
a
a
a
a
a
"}
(41,1,1) = {"
a
a
a
a
a
a
a
a
a
a
a
a
a
a
a
a
a
a
a
a
a
a
a
a
a
a
a
a
a
a
a
a
a
a
a
a
a
a
a
a
a
a
a
a
a
a
a
a
a
a
"}
(42,1,1) = {"
a
a
a
a
a
a
a
a
a
a
a
a
a
a
a
a
a
a
a
a
a
a
a
a
a
a
a
a
a
a
a
a
a
a
a
a
a
a
a
a
a
a
a
a
a
a
a
a
a
a
"}
(43,1,1) = {"
a
a
a
a
a
a
a
a
a
a
a
a
a
a
a
a
a
a
a
a
a
a
a
a
a
a
a
a
a
a
a
a
a
a
a
a
a
a
a
a
a
a
a
a
a
a
a
a
a
a
"}
(44,1,1) = {"
a
a
a
a
a
a
a
a
a
a
a
a
a
a
a
a
a
a
a
a
a
a
a
a
a
a
a
a
a
a
a
a
a
a
a
a
a
a
a
a
a
a
a
a
a
a
a
a
a
a
"}
(45,1,1) = {"
a
a
a
a
a
a
a
a
a
a
a
a
a
a
a
a
a
a
a
a
a
a
a
a
a
a
a
a
a
a
a
a
a
a
a
a
a
a
a
a
a
a
a
a
a
a
a
a
a
a
"}
(46,1,1) = {"
a
a
a
a
a
a
a
a
a
a
a
a
a
a
a
a
a
a
a
a
a
a
a
a
a
a
a
a
a
a
a
a
a
a
a
a
a
a
a
a
a
a
a
a
a
a
a
a
a
a
"}
(47,1,1) = {"
a
a
a
a
a
a
a
a
a
a
a
a
a
a
a
a
a
a
a
a
a
a
a
a
a
a
a
a
a
a
a
a
a
a
a
a
a
a
a
a
a
a
a
a
a
a
a
a
a
a
"}
(48,1,1) = {"
a
a
a
a
a
a
a
a
a
a
a
a
a
a
a
a
a
a
a
a
a
a
a
a
a
a
a
a
a
a
a
a
a
a
a
a
a
a
a
a
a
a
a
a
a
a
a
a
a
a
"}
(49,1,1) = {"
a
a
a
a
a
a
a
a
a
a
a
a
a
a
a
a
a
a
a
a
a
a
a
a
a
a
a
a
a
a
a
a
a
a
a
a
a
a
a
a
a
a
a
a
a
a
a
a
a
a
"}
(50,1,1) = {"
a
a
a
a
a
a
a
a
a
a
a
a
a
a
a
a
a
a
a
a
a
a
a
a
a
a
a
a
a
a
a
a
a
a
a
a
a
a
a
a
a
a
a
a
a
a
a
a
a
a
"}
