//MAP CONVERTED BY dmm2tgm.py THIS HEADER COMMENT PREVENTS RECONVERSION, DO NOT REMOVE
"ap" = (
/obj/effect/turf_decal/stripes/line{
	dir = 4
	},
/obj/structure/cable,
/turf/open/floor/plating/airless,
/area/ruin/space/has_grav/whodunit)
"dF" = (
/obj/machinery/door/airlock/external/ruin,
/obj/effect/mapping_helpers/airlock/cyclelink_helper{
	dir = 8
	},
/obj/structure/cable,
/turf/open/floor/plating,
/area/ruin/space/has_grav/whodunit)
"ez" = (
/obj/effect/turf_decal/siding/wideplating_new{
	dir = 5
	},
/turf/open/floor/iron/dark,
/area/ruin/space/has_grav/whodunit)
"fO" = (
/obj/structure/cable,
/turf/open/floor/plating,
/area/ruin/space/has_grav/whodunit)
"gK" = (
/obj/effect/turf_decal/siding/wideplating_new{
	dir = 1
	},
/turf/open/floor/iron/dark,
/area/ruin/space/has_grav/whodunit)
"hP" = (
/obj/effect/turf_decal/stripes/line{
	dir = 6
	},
/obj/structure/marker_beacon/burgundy,
/turf/open/floor/plating/airless,
/area/ruin/space/has_grav/whodunit)
"hT" = (
/obj/effect/turf_decal/stripes/line{
	dir = 9
	},
/obj/structure/marker_beacon/burgundy,
/turf/open/floor/plating/airless,
/area/ruin/space/has_grav/whodunit)
"iy" = (
/obj/effect/spawner/structure/window/hollow/reinforced/middle{
	dir = 4
	},
/turf/open/floor/plating,
/area/ruin/space/has_grav/whodunit)
"iZ" = (
/obj/effect/turf_decal/siding/wideplating_new/corner{
	dir = 8
	},
/turf/open/floor/iron/dark,
/area/ruin/space/has_grav/whodunit)
"jV" = (
/turf/open/floor/iron,
/area/ruin/space/has_grav/whodunit)
"lv" = (
/obj/effect/turf_decal/siding/wideplating_new{
	dir = 6
	},
/turf/open/floor/iron/dark,
/area/ruin/space/has_grav/whodunit)
"nd" = (
/obj/structure/chair/stool/directional/east,
/obj/effect/turf_decal/siding/wideplating_new{
	dir = 8
	},
/turf/open/floor/iron/dark,
/area/ruin/space/has_grav/whodunit)
"of" = (
/obj/effect/turf_decal/stripes/line,
/turf/open/floor/plating/airless,
/area/ruin/space/has_grav/whodunit)
"oD" = (
/obj/effect/spawner/structure/window/hollow/reinforced/middle,
/turf/open/floor/plating,
/area/ruin/space/has_grav/whodunit)
"pa" = (
/obj/structure/closet/crate/solarpanel_small,
/obj/structure/lattice,
/turf/template_noop,
/area/template_noop)
"pd" = (
/obj/effect/turf_decal/stripes/line{
	dir = 1
	},
/turf/open/floor/plating/airless,
/area/ruin/space/has_grav/whodunit)
"pR" = (
/obj/effect/turf_decal/siding/wideplating_new{
	dir = 10
	},
/turf/open/floor/iron/dark,
/area/ruin/space/has_grav/whodunit)
"sV" = (
/obj/effect/turf_decal/siding/wideplating_new/dark{
	dir = 5
	},
/obj/effect/spawner/random/trash/mopbucket,
/obj/item/mop/advanced,
/turf/open/floor/iron/smooth_large,
/area/ruin/space/has_grav/whodunit)
"th" = (
/obj/machinery/door/airlock/external/ruin,
/obj/effect/mapping_helpers/airlock/cyclelink_helper{
	dir = 8
	},
/turf/open/floor/plating,
/area/ruin/space/has_grav/whodunit)
"tF" = (
/turf/open/floor/iron/large,
/area/ruin/space/has_grav/whodunit)
"ue" = (
/obj/effect/turf_decal/stripes/line{
	dir = 8
	},
/turf/open/floor/plating/airless,
/area/ruin/space/has_grav/whodunit)
"vC" = (
/obj/effect/turf_decal/siding/wideplating_new/dark/corner,
/turf/open/floor/iron/smooth_large,
/area/ruin/space/has_grav/whodunit)
"vT" = (
/obj/effect/spawner/structure/window/reinforced,
/turf/open/floor/plating,
/area/ruin/space/has_grav/whodunit)
"vV" = (
/obj/effect/turf_decal/siding/wideplating_new{
	dir = 4
	},
/obj/structure/cable,
/turf/open/floor/iron/dark,
/area/ruin/space/has_grav/whodunit)
"wl" = (
/obj/effect/turf_decal/siding/wideplating_new/dark{
	dir = 10
	},
/turf/open/floor/iron/smooth_large,
/area/ruin/space/has_grav/whodunit)
"wW" = (
/turf/closed/wall,
/area/ruin/space/has_grav/whodunit)
"xb" = (
/obj/effect/turf_decal/siding/wideplating_new/dark{
	dir = 6
	},
/turf/open/floor/iron/smooth_large,
/area/ruin/space/has_grav/whodunit)
"xi" = (
/turf/open/floor/iron/smooth_large,
/area/ruin/space/has_grav/whodunit)
"yn" = (
/obj/structure/chair/stool/directional/west,
/obj/effect/turf_decal/siding/wideplating_new{
	dir = 4
	},
/obj/structure/cable,
/turf/open/floor/iron/dark,
/area/ruin/space/has_grav/whodunit)
"zJ" = (
/obj/effect/turf_decal/siding/wideplating_new{
	dir = 4
	},
/turf/open/floor/iron/dark,
/area/ruin/space/has_grav/whodunit)
"Ah" = (
/obj/effect/turf_decal/siding/wideplating_new/dark/corner{
	dir = 1
	},
/turf/open/floor/iron/smooth_large,
/area/ruin/space/has_grav/whodunit)
"Aj" = (
/obj/structure/sink/directional/south,
/obj/structure/mirror/directional/north,
/turf/open/floor/iron/showroomfloor,
/area/ruin/space/has_grav/whodunit)
"AS" = (
/obj/structure/chair/stool/directional/west,
/obj/effect/turf_decal/siding/wideplating_new{
	dir = 4
	},
/turf/open/floor/iron/dark,
/area/ruin/space/has_grav/whodunit)
"AX" = (
/obj/effect/turf_decal/siding/wideplating_new/dark{
	dir = 1
	},
/turf/open/floor/iron/smooth_large,
/area/ruin/space/has_grav/whodunit)
"Bq" = (
/obj/effect/turf_decal/siding/wideplating_new/corner,
/turf/open/floor/iron/dark,
/area/ruin/space/has_grav/whodunit)
"Bx" = (
/obj/effect/turf_decal/siding/wideplating_new{
	dir = 1
	},
/obj/effect/turf_decal/siding/wideplating_new,
/obj/machinery/door/airlock/silver,
/turf/open/floor/iron/smooth_large,
/area/ruin/space/has_grav/whodunit)
"BC" = (
/obj/structure/chair/stool/directional/south,
/obj/effect/turf_decal/siding/wideplating_new{
	dir = 1
	},
/turf/open/floor/iron/dark,
/area/ruin/space/has_grav/whodunit)
"BK" = (
/obj/structure/noticeboard/directional/north,
/obj/item/paper/fluff/ruins/whodunit/rules,
/turf/open/floor/iron,
/area/ruin/space/has_grav/whodunit)
"BL" = (
/obj/structure/closet/crate/trashcart/filled,
/obj/item/paper/fluff/ruins/whodunit/ihaveaclue,
/turf/open/floor/iron,
/area/ruin/space/has_grav/whodunit)
"DE" = (
/obj/machinery/power/apc/auto_name/directional/north,
/obj/structure/cable,
/turf/open/floor/iron,
/area/ruin/space/has_grav/whodunit)
"Ea" = (
/obj/effect/turf_decal/siding/wideplating_new{
	dir = 9
	},
/turf/open/floor/iron/dark,
/area/ruin/space/has_grav/whodunit)
"FW" = (
/obj/structure/chair/stool/directional/north,
/obj/effect/turf_decal/siding/wideplating_new,
/turf/open/floor/iron/dark,
/area/ruin/space/has_grav/whodunit)
"FX" = (
/turf/open/floor/plating,
/area/ruin/space/has_grav/whodunit)
"Gu" = (
/obj/effect/turf_decal/stripes/line,
/obj/machinery/door/airlock/external/ruin,
/obj/effect/mapping_helpers/airlock/cyclelink_helper{
	dir = 1
	},
/turf/open/floor/plating,
/area/ruin/space/has_grav/whodunit)
"Ij" = (
/obj/item/crowbar,
/turf/open/floor/iron,
/area/ruin/space/has_grav/whodunit)
"Ip" = (
/obj/effect/turf_decal/siding/wideplating_new/dark{
	dir = 5
	},
/turf/open/floor/iron/smooth_large,
/area/ruin/space/has_grav/whodunit)
"IU" = (
/obj/effect/turf_decal/siding/wideplating_new/dark/corner{
	dir = 8
	},
/turf/open/floor/iron/smooth_large,
/area/ruin/space/has_grav/whodunit)
"JZ" = (
/obj/effect/turf_decal/siding/wideplating_new{
	dir = 8
	},
/turf/open/floor/iron/dark,
/area/ruin/space/has_grav/whodunit)
"LZ" = (
/obj/effect/turf_decal/stripes/line{
	dir = 1
	},
/obj/machinery/door/airlock/external/ruin,
/obj/effect/mapping_helpers/airlock/cyclelink_helper,
/turf/open/floor/plating,
/area/ruin/space/has_grav/whodunit)
"Mj" = (
/turf/open/floor/plating,
/turf/closed/wall,
/area/ruin/space/has_grav/whodunit)
"MJ" = (
/turf/template_noop,
/area/template_noop)
"Og" = (
/obj/effect/turf_decal/siding/wideplating_new/dark{
	dir = 4
	},
/turf/open/floor/iron/smooth_large,
/area/ruin/space/has_grav/whodunit)
"OZ" = (
/obj/effect/turf_decal/siding/wideplating_new/corner{
	dir = 1
	},
/turf/open/floor/iron/dark,
/area/ruin/space/has_grav/whodunit)
"Pj" = (
/obj/effect/turf_decal/siding/wideplating_new,
/turf/open/floor/iron/dark,
/area/ruin/space/has_grav/whodunit)
"Qg" = (
/obj/structure/toilet/secret{
	dir = 8
	},
/turf/open/floor/iron/showroomfloor,
/area/ruin/space/has_grav/whodunit)
"QM" = (
/obj/effect/turf_decal/stripes/line{
	dir = 10
	},
/obj/structure/marker_beacon/burgundy,
/turf/open/floor/plating/airless,
/area/ruin/space/has_grav/whodunit)
"Rt" = (
/obj/effect/decal/cleanable/blood/drip,
/turf/open/floor/iron/showroomfloor,
/area/ruin/space/has_grav/whodunit)
"RY" = (
/obj/effect/turf_decal/siding/wideplating_new/dark/corner{
	dir = 4
	},
/turf/open/floor/iron/smooth_large,
/area/ruin/space/has_grav/whodunit)
"So" = (
/obj/machinery/door/airlock/external/ruin,
/obj/effect/mapping_helpers/airlock/cyclelink_helper{
	dir = 4
	},
/obj/structure/cable,
/turf/open/floor/plating,
/area/ruin/space/has_grav/whodunit)
"TZ" = (
/obj/effect/turf_decal/siding/wideplating_new{
	dir = 5
	},
/obj/structure/cable,
/turf/open/floor/iron/dark,
/area/ruin/space/has_grav/whodunit)
"UL" = (
/obj/structure/cable,
/turf/open/floor/iron,
/area/ruin/space/has_grav/whodunit)
"UR" = (
/obj/effect/turf_decal/siding/wideplating_new/dark{
	dir = 8
	},
/turf/open/floor/iron/smooth_large,
/area/ruin/space/has_grav/whodunit)
"Vt" = (
/obj/effect/turf_decal/siding/wideplating_new/dark{
	dir = 9
	},
/turf/open/floor/iron/smooth_large,
/area/ruin/space/has_grav/whodunit)
"Wy" = (
/obj/effect/turf_decal/siding/wideplating_new/corner{
	dir = 4
	},
/turf/open/floor/iron/dark,
/area/ruin/space/has_grav/whodunit)
"Xa" = (
/obj/machinery/door/airlock/external/ruin,
/obj/effect/mapping_helpers/airlock/cyclelink_helper{
	dir = 4
	},
/turf/open/floor/plating,
/area/ruin/space/has_grav/whodunit)
"XJ" = (
/obj/structure/lattice,
/turf/template_noop,
/area/template_noop)
"Zr" = (
/obj/structure/flora/bush/flowers_br/style_2,
/obj/structure/flora/bush/ferny,
/obj/structure/railing{
	dir = 4
	},
/obj/effect/turf_decal/siding/wideplating_new{
	dir = 4
	},
/turf/open/floor/grass,
/area/ruin/space/has_grav/whodunit)
"ZU" = (
/obj/effect/turf_decal/siding/wideplating_new/dark,
/turf/open/floor/iron/smooth_large,
/area/ruin/space/has_grav/whodunit)
"ZV" = (
/obj/effect/turf_decal/stripes/line{
	dir = 5
	},
/obj/structure/marker_beacon/burgundy,
/turf/open/floor/plating/airless,
/area/ruin/space/has_grav/whodunit)

(1,1,1) = {"
MJ
MJ
MJ
MJ
MJ
MJ
MJ
MJ
hT
ue
QM
MJ
MJ
MJ
MJ
MJ
MJ
MJ
MJ
"}
(2,1,1) = {"
MJ
MJ
MJ
MJ
MJ
MJ
MJ
MJ
wW
Xa
wW
MJ
MJ
MJ
MJ
MJ
MJ
MJ
MJ
"}
(3,1,1) = {"
MJ
MJ
MJ
MJ
MJ
MJ
MJ
MJ
oD
FX
oD
MJ
MJ
MJ
MJ
MJ
MJ
MJ
MJ
"}
(4,1,1) = {"
MJ
MJ
MJ
MJ
MJ
wW
vT
vT
wW
th
wW
vT
vT
wW
MJ
MJ
MJ
MJ
MJ
"}
(5,1,1) = {"
MJ
MJ
MJ
MJ
wW
wW
jV
jV
jV
jV
jV
jV
jV
wW
wW
MJ
MJ
MJ
MJ
"}
(6,1,1) = {"
MJ
MJ
MJ
wW
wW
BL
Ea
nd
JZ
nd
JZ
nd
pR
jV
wW
wW
MJ
MJ
MJ
"}
(7,1,1) = {"
hT
wW
iy
wW
jV
Ea
OZ
Vt
UR
UR
UR
wl
iZ
pR
jV
vT
MJ
MJ
MJ
"}
(8,1,1) = {"
pd
LZ
FX
Gu
jV
BC
Vt
Ah
xi
xi
xi
IU
wl
FW
jV
vT
MJ
MJ
MJ
"}
(9,1,1) = {"
ZV
wW
Mj
wW
BK
gK
AX
xi
tF
xi
tF
xi
ZU
Pj
jV
wW
iy
wW
QM
"}
(10,1,1) = {"
wW
wW
Zr
wW
jV
BC
AX
xi
xi
tF
xi
xi
ZU
FW
jV
LZ
FX
Gu
of
"}
(11,1,1) = {"
wW
Aj
Rt
Bx
Ij
gK
AX
xi
tF
xi
tF
xi
ZU
Pj
jV
wW
iy
wW
hP
"}
(12,1,1) = {"
wW
wW
Qg
Mj
jV
BC
sV
RY
xi
xi
xi
vC
xb
FW
jV
vT
MJ
MJ
MJ
"}
(13,1,1) = {"
MJ
wW
wW
Mj
jV
ez
Wy
Ip
Og
Og
Og
xb
Bq
lv
jV
vT
MJ
MJ
MJ
"}
(14,1,1) = {"
MJ
MJ
MJ
wW
wW
DE
TZ
yn
vV
yn
zJ
AS
lv
jV
wW
wW
MJ
MJ
MJ
"}
(15,1,1) = {"
MJ
MJ
MJ
MJ
wW
wW
jV
jV
jV
UL
jV
jV
jV
wW
wW
MJ
MJ
MJ
MJ
"}
(16,1,1) = {"
MJ
MJ
MJ
MJ
MJ
wW
vT
vT
wW
So
wW
vT
vT
wW
MJ
MJ
MJ
MJ
MJ
"}
(17,1,1) = {"
MJ
MJ
MJ
MJ
MJ
MJ
MJ
MJ
oD
fO
oD
MJ
MJ
MJ
MJ
MJ
MJ
MJ
MJ
"}
(18,1,1) = {"
MJ
MJ
MJ
MJ
MJ
MJ
MJ
MJ
wW
dF
wW
MJ
MJ
MJ
MJ
MJ
MJ
MJ
MJ
"}
(19,1,1) = {"
MJ
MJ
MJ
MJ
MJ
MJ
MJ
XJ
ZV
ap
hP
MJ
MJ
MJ
MJ
MJ
MJ
MJ
MJ
"}
(20,1,1) = {"
MJ
MJ
MJ
MJ
MJ
MJ
MJ
XJ
MJ
XJ
MJ
MJ
MJ
MJ
MJ
MJ
MJ
MJ
MJ
"}
(21,1,1) = {"
MJ
MJ
MJ
MJ
MJ
MJ
MJ
pa
XJ
XJ
MJ
MJ
MJ
MJ
MJ
MJ
MJ
MJ
MJ
"}
