//MAP CONVERTED BY dmm2tgm.py THIS HEADER COMMENT PREVENTS RECONVERSION, DO NOT REMOVE
"ao" = (
/obj/structure/table,
/obj/item/storage/medkit/regular{
	pixel_x = 2;
	pixel_y = 3
	},
/obj/item/crowbar,
/obj/item/storage/medkit/fire,
/turf/open/floor/wood,
/area/shuttle/escape)
"bf" = (
/obj/structure/table,
/obj/item/screwdriver,
/turf/open/floor/pod,
/area/shuttle/escape)
"bE" = (
/obj/structure/table,
/obj/item/reagent_containers/cup/glass/bottle/juice/orangejuice{
	pixel_y = 6;
	pixel_x = -7
	},
/obj/item/reagent_containers/cup/glass/bottle/vodka{
	pixel_y = 10;
	pixel_x = 9
	},
/obj/item/reagent_containers/cup/glass/bottle/vodka{
	pixel_x = -3;
	pixel_y = 4
	},
/turf/open/floor/pod,
/area/shuttle/escape)
"bU" = (
/obj/structure/table,
/obj/item/paper_bin{
	pixel_y = 5
	},
/obj/item/pen,
/turf/open/floor/pod,
/area/shuttle/escape)
"cd" = (
/obj/structure/chair/comfy/shuttle{
	dir = 4
	},
/obj/machinery/camera/autoname/directional/west,
/turf/open/floor/pod,
/area/shuttle/escape)
"cM" = (
/obj/effect/turf_decal/bot,
/obj/effect/spawner/random/structure/crate,
/turf/open/floor/iron/smooth,
/area/shuttle/escape)
"db" = (
/obj/effect/spawner/random/vending/snackvend,
/turf/open/floor/pod,
/area/shuttle/escape)
"dL" = (
/turf/closed/wall/mineral/titanium/survival/nodiagonal,
/area/shuttle/escape)
"eK" = (
/obj/structure/chair/comfy/shuttle{
	dir = 8
	},
/obj/machinery/light/small/directional/east,
/turf/open/floor/iron/white,
/area/shuttle/escape)
"eT" = (
/obj/machinery/light/small/directional/west,
/turf/open/floor/carpet/purple,
/area/shuttle/escape)
"fn" = (
/obj/effect/turf_decal/stripes/line,
/obj/structure/window/reinforced/survival_pod/spawner/directional/north,
/obj/structure/window/reinforced/survival_pod/spawner/directional/south,
/turf/open/floor/fakespace,
/area/shuttle/escape)
"fR" = (
/obj/machinery/status_display/ai/directional/west,
/turf/open/floor/wood,
/area/shuttle/escape)
"fS" = (
/obj/structure/chair/comfy/shuttle{
	dir = 1
	},
/obj/effect/turf_decal/siding/wood{
	dir = 6
	},
/turf/open/floor/carpet/royalblue,
/area/shuttle/escape)
"fU" = (
/obj/structure/chair/comfy/shuttle{
	dir = 4
	},
/obj/item/radio/intercom/directional/south,
/turf/open/floor/wood,
/area/shuttle/escape)
"gn" = (
/turf/closed/wall/mineral/plastitanium,
/area/shuttle/escape)
"gx" = (
/obj/structure/chair/sofa/bench/left{
	dir = 8
	},
/obj/structure/extinguisher_cabinet/directional/east,
/turf/open/floor/pod/dark,
/area/shuttle/escape)
"gE" = (
/obj/machinery/computer/communications{
	dir = 8
	},
/obj/effect/turf_decal/siding/wood{
	dir = 8
	},
/turf/open/floor/carpet/red,
/area/shuttle/escape)
"gY" = (
/obj/machinery/door/airlock/research,
/turf/open/floor/pod,
/area/shuttle/escape)
"hp" = (
/obj/machinery/power/shuttle_engine/propulsion,
/turf/open/floor/plating/airless,
/area/shuttle/escape)
"hw" = (
/obj/machinery/door/airlock/survival_pod/glass,
/obj/effect/mapping_helpers/airlock/access/all/security/general,
/obj/effect/turf_decal/stripes/line{
	dir = 8
	},
/obj/effect/turf_decal/stripes/line{
	dir = 4
	},
/turf/open/floor/plating,
/area/shuttle/escape)
"hT" = (
/obj/structure/reagent_dispensers/water_cooler,
/turf/open/floor/pod,
/area/shuttle/escape)
"jh" = (
/obj/effect/turf_decal/tile/neutral{
	dir = 1
	},
/obj/structure/chair/comfy/shuttle{
	dir = 4
	},
/turf/open/floor/pod,
/area/shuttle/escape)
"ji" = (
/obj/machinery/status_display/evac/directional/south,
/obj/machinery/camera/autoname/directional/south,
/turf/open/floor/wood,
/area/shuttle/escape)
"jv" = (
/obj/item/kirbyplants/random,
/turf/open/floor/pod,
/area/shuttle/escape)
"ky" = (
/obj/structure/table,
/obj/item/surgery_tray/full,
/turf/open/floor/iron/white,
/area/shuttle/escape)
"kX" = (
/obj/machinery/computer/atmos_alert{
	dir = 4
	},
/obj/machinery/light/directional/west,
/obj/effect/turf_decal/siding/wood{
	dir = 4
	},
/turf/open/floor/carpet/green,
/area/shuttle/escape)
"lq" = (
/obj/effect/spawner/structure/window/reinforced/plasma/plastitanium,
/turf/open/floor/plating,
/area/shuttle/escape)
"lN" = (
/obj/effect/turf_decal/siding/wood{
	dir = 1
	},
/obj/effect/turf_decal/siding/wood,
/turf/open/floor/pod,
/area/shuttle/escape)
"mc" = (
/obj/effect/spawner/random/vending/colavend,
/turf/open/floor/pod,
/area/shuttle/escape)
"mG" = (
/obj/structure/table,
/obj/machinery/recharger,
/turf/open/floor/mineral/plastitanium/red,
/area/shuttle/escape/brig)
"nc" = (
/obj/machinery/light/small/directional/west,
/turf/open/floor/iron/smooth,
/area/shuttle/escape)
"nN" = (
/obj/structure/chair/comfy/shuttle{
	dir = 4
	},
/obj/effect/turf_decal/tile/neutral{
	dir = 8
	},
/turf/open/floor/pod,
/area/shuttle/escape)
"of" = (
/obj/machinery/power/shuttle_engine/heater,
/obj/effect/turf_decal/stripes/line{
	dir = 1
	},
/obj/structure/window/reinforced/survival_pod/spawner/directional/north,
/turf/open/floor/plating/airless,
/area/shuttle/escape)
"oq" = (
/obj/machinery/door/airlock/medical/glass,
/obj/effect/turf_decal/siding/dark{
	dir = 1
	},
/turf/open/floor/iron/white,
/area/shuttle/escape)
"or" = (
/obj/machinery/computer/security/wooden_tv,
/turf/open/floor/pod,
/area/shuttle/escape)
"oA" = (
/obj/machinery/button/flasher{
	id = "cockpit_flasher";
	pixel_x = 24
	},
/turf/open/floor/wood,
/area/shuttle/escape)
"oE" = (
/obj/structure/chair/sofa/corp/right,
/turf/open/floor/carpet/purple,
/area/shuttle/escape)
"px" = (
/obj/structure/chair/comfy/shuttle,
/obj/machinery/camera/autoname/directional/north,
/turf/open/floor/mineral/plastitanium/red,
/area/shuttle/escape/brig)
"pD" = (
/obj/structure/chair/sofa/bench/left{
	dir = 4
	},
/turf/open/floor/pod/dark,
/area/shuttle/escape)
"pE" = (
/obj/structure/extinguisher_cabinet/directional/east,
/turf/open/floor/pod/dark,
/area/shuttle/escape)
"pF" = (
/obj/effect/turf_decal/bot,
/obj/structure/closet/crate/engineering,
/obj/item/tank/internals/emergency_oxygen/engi,
/turf/open/floor/iron/smooth,
/area/shuttle/escape)
"qc" = (
/obj/structure/chair/sofa/bench/right{
	dir = 8
	},
/obj/machinery/light/small/directional/east,
/turf/open/floor/pod/dark,
/area/shuttle/escape)
"qN" = (
/obj/structure/extinguisher_cabinet/directional/east,
/turf/open/floor/iron/white,
/area/shuttle/escape)
"qQ" = (
/obj/structure/chair/comfy/shuttle{
	dir = 8
	},
/obj/machinery/camera/autoname/directional/east,
/turf/open/floor/pod,
/area/shuttle/escape)
"sd" = (
/obj/effect/turf_decal/siding/wood{
	dir = 1
	},
/obj/effect/turf_decal/siding/wood,
/obj/machinery/light/small/directional/west,
/turf/open/floor/pod,
/area/shuttle/escape)
"sN" = (
/obj/machinery/status_display/evac/directional/south,
/turf/open/floor/pod/dark,
/area/shuttle/escape)
"tL" = (
/obj/effect/turf_decal/siding/dark{
	dir = 5
	},
/obj/structure/window/reinforced/survival_pod/spawner/directional/east,
/obj/structure/window/reinforced/survival_pod/spawner/directional/north,
/obj/structure/flora/bush/lavendergrass/style_random,
/turf/open/floor/grass,
/area/shuttle/escape)
"ue" = (
/turf/open/floor/pod,
/area/shuttle/escape)
"uf" = (
/turf/closed/wall/mineral/titanium/survival,
/area/shuttle/escape)
"uh" = (
/obj/machinery/camera/autoname/directional/north,
/turf/open/floor/pod/dark,
/area/shuttle/escape)
"vX" = (
/obj/effect/spawner/structure/window/survival_pod,
/turf/open/floor/plating,
/area/shuttle/escape)
"wv" = (
/obj/effect/turf_decal/bot,
/turf/open/floor/iron/smooth,
/area/shuttle/escape)
"xa" = (
/obj/structure/chair/comfy/shuttle{
	dir = 8
	},
/turf/open/floor/pod,
/area/shuttle/escape)
"xf" = (
/obj/machinery/door/airlock/command,
/obj/effect/mapping_helpers/airlock/access/all/command/general,
/obj/effect/mapping_helpers/airlock/cyclelink_helper{
	dir = 1
	},
/obj/effect/turf_decal/siding/wood,
/turf/open/floor/wood,
/area/shuttle/escape)
"ym" = (
/obj/structure/chair/comfy/shuttle{
	dir = 8
	},
/turf/open/floor/wood,
/area/shuttle/escape)
"zD" = (
/obj/effect/turf_decal/siding/dark{
	dir = 1
	},
/obj/structure/window/reinforced/survival_pod/spawner/directional/north,
/obj/structure/flora/bush/grassy/style_random,
/obj/structure/flora/bush/flowers_br/style_random,
/turf/open/floor/grass,
/area/shuttle/escape)
"AY" = (
/obj/machinery/computer/crew{
	dir = 4
	},
/obj/effect/turf_decal/siding/wood{
	dir = 4
	},
/turf/open/floor/carpet/green,
/area/shuttle/escape)
"AZ" = (
/obj/structure/chair/comfy/shuttle{
	dir = 1
	},
/obj/effect/turf_decal/siding/wood{
	dir = 10
	},
/turf/open/floor/carpet/royalblue,
/area/shuttle/escape)
"BA" = (
/obj/machinery/door/airlock/command,
/obj/effect/mapping_helpers/airlock/access/all/command/general,
/obj/effect/mapping_helpers/airlock/cyclelink_helper,
/turf/open/floor/wood,
/area/shuttle/escape)
"Cg" = (
/obj/structure/table,
/obj/item/storage/medkit/regular{
	pixel_y = 5;
	pixel_x = 2
	},
/obj/item/storage/medkit/fire{
	pixel_y = 3
	},
/obj/item/crowbar,
/obj/machinery/camera/autoname/directional/south{
	dir = 5
	},
/turf/open/floor/iron/white,
/area/shuttle/escape)
"Cn" = (
/obj/structure/chair/comfy/shuttle,
/turf/open/floor/mineral/plastitanium/red,
/area/shuttle/escape/brig)
"Cp" = (
/obj/machinery/computer/security{
	dir = 8
	},
/obj/machinery/light/directional/east,
/obj/effect/turf_decal/siding/wood{
	dir = 8
	},
/turf/open/floor/carpet/red,
/area/shuttle/escape)
"Da" = (
/obj/machinery/computer/operating{
	dir = 4
	},
/obj/machinery/vending/wallmed/directional/west,
/turf/open/floor/iron/white,
/area/shuttle/escape)
"DD" = (
/obj/machinery/door/airlock/survival_pod/glass,
/obj/docking_port/mobile/emergency{
	name = "Holestation emergency shuttle"
	},
/obj/effect/turf_decal/stripes/line{
	dir = 8
	},
/obj/effect/turf_decal/stripes/line{
	dir = 4
	},
/turf/open/floor/plating,
/area/shuttle/escape)
"EY" = (
/obj/structure/chair/comfy/shuttle{
	dir = 8
	},
/obj/effect/turf_decal/tile/neutral{
	dir = 4
	},
/turf/open/floor/pod,
/area/shuttle/escape)
"FU" = (
/obj/effect/turf_decal/siding/dark{
	dir = 1
	},
/obj/structure/window/reinforced/survival_pod/spawner/directional/north,
/obj/structure/flora/grass/jungle/a/style_random,
/obj/item/toy/plush/effigy/blue_cat,
/turf/open/floor/grass,
/area/shuttle/escape)
"FZ" = (
/obj/machinery/computer/emergency_shuttle,
/obj/effect/turf_decal/siding/wood,
/turf/open/floor/carpet/royalblue,
/area/shuttle/escape)
"Gn" = (
/obj/machinery/door/airlock/security,
/obj/effect/mapping_helpers/airlock/access/all/security/general,
/turf/open/floor/mineral/plastitanium/red,
/area/shuttle/escape/brig)
"GP" = (
/obj/machinery/door/airlock/engineering,
/turf/open/floor/pod,
/area/shuttle/escape)
"Jk" = (
/obj/effect/turf_decal/stripes/line{
	dir = 1
	},
/obj/machinery/door/airlock/mining/glass,
/turf/open/floor/iron/smooth,
/area/shuttle/escape)
"KO" = (
/obj/structure/chair/comfy/shuttle{
	dir = 8
	},
/obj/machinery/light/small/directional/east,
/turf/open/floor/mineral/plastitanium/red,
/area/shuttle/escape/brig)
"KZ" = (
/obj/structure/chair/sofa/bench/right{
	dir = 4
	},
/turf/open/floor/pod/dark,
/area/shuttle/escape)
"Lt" = (
/obj/structure/chair/comfy/shuttle{
	dir = 8
	},
/obj/effect/turf_decal/tile/neutral,
/turf/open/floor/pod,
/area/shuttle/escape)
"LC" = (
/turf/open/floor/wood,
/area/shuttle/escape)
"Mv" = (
/obj/machinery/door/airlock/survival_pod/glass,
/obj/effect/turf_decal/stripes/line{
	dir = 8
	},
/obj/effect/turf_decal/stripes/line{
	dir = 4
	},
/turf/open/floor/plating,
/area/shuttle/escape)
"Nn" = (
/obj/structure/table,
/obj/machinery/recharger,
/turf/open/floor/wood,
/area/shuttle/escape)
"Oa" = (
/obj/structure/table/optable,
/obj/machinery/defibrillator_mount/directional/west,
/turf/open/floor/iron/white,
/area/shuttle/escape)
"Pk" = (
/obj/effect/turf_decal/siding/dark{
	dir = 1
	},
/obj/structure/window/reinforced/survival_pod/spawner/directional/north,
/obj/structure/flora/grass/jungle/a/style_random,
/turf/open/floor/grass,
/area/shuttle/escape)
"Pv" = (
/obj/machinery/flasher/directional/north{
	id = "cockpit_flasher"
	},
/turf/open/floor/pod/dark,
/area/shuttle/escape)
"PF" = (
/obj/effect/turf_decal/siding/dark{
	dir = 9
	},
/obj/structure/window/reinforced/survival_pod/spawner/directional/west,
/obj/structure/window/reinforced/survival_pod/spawner/directional/north,
/obj/structure/flora/rock/pile/jungle/style_random,
/obj/structure/flora/bush/flowers_pp,
/turf/open/floor/grass,
/area/shuttle/escape)
"RU" = (
/obj/structure/chair/sofa/corp/left,
/obj/machinery/camera/autoname/directional/north{
	dir = 9
	},
/turf/open/floor/carpet/purple,
/area/shuttle/escape)
"Sd" = (
/turf/open/floor/mineral/plastitanium/red,
/area/shuttle/escape/brig)
"Sf" = (
/obj/structure/extinguisher_cabinet/directional/west,
/obj/machinery/camera/autoname/directional/south,
/turf/open/floor/iron/smooth,
/area/shuttle/escape)
"SA" = (
/obj/machinery/light/directional/west,
/turf/open/floor/pod/dark,
/area/shuttle/escape)
"SX" = (
/obj/machinery/status_display/evac/directional/east,
/obj/item/kirbyplants/random,
/turf/open/floor/wood,
/area/shuttle/escape)
"TB" = (
/obj/structure/chair/comfy/shuttle{
	dir = 8
	},
/turf/open/floor/mineral/plastitanium/red,
/area/shuttle/escape/brig)
"TH" = (
/obj/structure/table/wood,
/obj/item/reagent_containers/cup/glass/coffee{
	pixel_y = 8;
	pixel_x = 6
	},
/obj/item/reagent_containers/cup/glass/coffee,
/turf/open/floor/carpet/purple,
/area/shuttle/escape)
"Ui" = (
/obj/effect/turf_decal/stripes/line,
/obj/structure/window/reinforced/survival_pod/spawner/directional/north,
/obj/structure/window/reinforced/survival_pod/spawner/directional/south,
/obj/item/toy/plush/effigy/glitch_synth,
/turf/open/floor/fakespace,
/area/shuttle/escape)
"Wf" = (
/obj/machinery/light/directional/east,
/turf/open/floor/pod/dark,
/area/shuttle/escape)
"WT" = (
/obj/structure/chair/comfy/shuttle{
	dir = 4
	},
/turf/open/floor/pod,
/area/shuttle/escape)
"XK" = (
/turf/open/floor/pod/dark,
/area/shuttle/escape)
"Yi" = (
/obj/effect/turf_decal/stripes/line{
	dir = 9
	},
/obj/effect/decal/cleanable/generic,
/obj/item/reagent_containers/cup/glass/coffee{
	pixel_y = -3;
	pixel_x = 6
	},
/turf/open/floor/plating/airless,
/area/shuttle/escape)
"Yn" = (
/turf/open/floor/iron/smooth,
/area/shuttle/escape)
"Yv" = (
/turf/closed/wall/mineral/plastitanium/nodiagonal,
/area/shuttle/escape)
"Za" = (
/obj/structure/chair/comfy/shuttle{
	dir = 8
	},
/obj/structure/extinguisher_cabinet/directional/south,
/turf/open/floor/wood,
/area/shuttle/escape)
"Zw" = (
/obj/structure/chair/comfy/shuttle{
	dir = 4
	},
/turf/open/floor/wood,
/area/shuttle/escape)
"ZG" = (
/turf/template_noop,
/area/template_noop)

(1,1,1) = {"
ZG
ZG
ZG
ZG
uf
dL
dL
hw
dL
DD
dL
vX
vX
vX
dL
Mv
dL
Mv
dL
dL
gn
ZG
"}
(2,1,1) = {"
ZG
ZG
ZG
Yi
dL
px
Sd
Sd
vX
XK
SA
XK
XK
XK
SA
XK
Jk
Yn
nc
Sf
Yv
gn
"}
(3,1,1) = {"
ZG
uf
dL
dL
dL
Cn
Sd
Sd
Gn
XK
Lt
qQ
xa
xa
EY
XK
vX
cM
pF
wv
of
hp
"}
(4,1,1) = {"
uf
dL
kX
AY
dL
mG
KO
TB
vX
XK
PF
Yv
lq
Yv
bU
sN
dL
dL
dL
dL
Yv
hp
"}
(5,1,1) = {"
vX
Nn
ym
Za
dL
dL
dL
dL
dL
Pv
zD
lq
ZG
lq
hT
XK
dL
uh
pD
KZ
fn
hp
"}
(6,1,1) = {"
vX
AZ
LC
LC
BA
fR
sd
LC
xf
XK
Pk
lq
ZG
lq
db
XK
GP
ue
bE
bf
fn
Yv
"}
(7,1,1) = {"
vX
FZ
LC
LC
vX
SX
lN
oA
vX
XK
FU
lq
ZG
lq
mc
XK
dL
XK
qc
gx
Ui
hp
"}
(8,1,1) = {"
vX
fS
LC
ji
dL
dL
dL
dL
dL
Pv
tL
Yv
lq
Yv
jv
sN
dL
dL
dL
dL
Yv
hp
"}
(9,1,1) = {"
vX
ao
Zw
fU
dL
oE
eT
ue
gY
XK
nN
WT
WT
cd
jh
XK
vX
Da
Oa
ky
of
hp
"}
(10,1,1) = {"
uf
dL
Cp
gE
dL
RU
TH
or
dL
pE
Wf
XK
XK
XK
Wf
XK
oq
qN
eK
Cg
Yv
gn
"}
(11,1,1) = {"
ZG
uf
dL
dL
dL
dL
vX
dL
dL
dL
dL
vX
vX
vX
dL
dL
dL
dL
dL
dL
gn
ZG
"}
