//MAP CONVERTED BY dmm2tgm.py THIS HEADER COMMENT PREVENTS RECONVERSION, DO NOT REMOVE
"a" = (
/turf/closed/wall,
/area/station/commons/fitness/recreation)
"b" = (
/obj/machinery/cryopod{
	dir = 8
	},
/obj/effect/turf_decal/siding/white{
	dir = 8
	},
/turf/open/floor/iron/dark,
/area/station/commons/cryo)
"g" = (
/obj/structure/cable,
/obj/machinery/atmospherics/pipe/smart/manifold4w/supply/hidden/layer4,
/obj/machinery/atmospherics/pipe/smart/manifold4w/scrubbers/hidden/layer2,
/obj/machinery/door/airlock/public/glass{
	name = "Cryopods"
	},
/turf/open/floor/iron,
/area/station/commons/cryo)
"i" = (
/obj/structure/lattice,
/turf/open/space/basic,
/area/space/nearstation)
"j" = (
/obj/structure/lattice,
/obj/effect/spawner/random/structure/grille,
/turf/open/space/basic,
/area/space/nearstation)
"m" = (
/turf/open/space/basic,
/area/space)
"u" = (
/obj/machinery/cryopod{
	dir = 4
	},
/obj/effect/turf_decal/siding/white{
	dir = 4
	},
/obj/machinery/camera/directional/north,
/turf/open/floor/iron/dark,
/area/station/commons/cryo)
"v" = (
/obj/machinery/atmospherics/pipe/smart/manifold4w/supply/hidden/layer4,
/turf/open/floor/iron,
/area/station/commons/cryo)
"w" = (
/obj/machinery/cryopod{
	dir = 8
	},
/obj/effect/turf_decal/siding/white{
	dir = 8
	},
/obj/machinery/power/apc/auto_name/directional/east,
/obj/structure/cable,
/turf/open/floor/iron/dark,
/area/station/commons/cryo)
"y" = (
/obj/machinery/light/directional/north,
/obj/machinery/atmospherics/components/unary/vent_pump/on/layer4,
/turf/open/floor/iron,
/area/station/commons/cryo)
"C" = (
/obj/structure/cable,
/obj/machinery/atmospherics/pipe/smart/manifold4w/supply/hidden/layer4,
/obj/machinery/atmospherics/pipe/smart/manifold4w/scrubbers/hidden/layer2,
/turf/open/floor/iron,
/area/station/commons/cryo)
"D" = (
/obj/effect/spawner/structure/window/reinforced,
/turf/open/floor/plating,
/area/station/commons/cryo)
"G" = (
/obj/machinery/cryopod{
	dir = 4
	},
/obj/effect/turf_decal/siding/white{
	dir = 4
	},
/turf/open/floor/iron/dark,
/area/station/commons/cryo)
"H" = (
/turf/closed/wall,
/area/station/commons/cryo)
"J" = (
/obj/machinery/cryopod{
	dir = 8
	},
/obj/effect/turf_decal/siding/white{
	dir = 8
	},
/obj/machinery/airalarm/directional/north,
/turf/open/floor/iron/dark,
/area/station/commons/cryo)
"N" = (
/obj/effect/spawner/structure/window,
/turf/open/floor/plating,
/area/station/commons/cryo)
"O" = (
/obj/effect/spawner/structure/window/reinforced,
/turf/open/floor/plating,
/area/station/commons/fitness/recreation)
"P" = (
/obj/effect/turf_decal/siding/white{
	dir = 4
	},
/obj/machinery/computer/cryopod/directional/west,
/obj/machinery/atmospherics/components/unary/vent_scrubber/on/layer2{
	dir = 4
	},
/turf/open/floor/iron/dark,
/area/station/commons/cryo)

(1,1,1) = {"
H
H
D
H
H
"}
(2,1,1) = {"
H
u
G
P
N
"}
(3,1,1) = {"
H
y
v
C
g
"}
(4,1,1) = {"
H
J
b
w
N
"}
(5,1,1) = {"
H
H
D
H
H
"}
(6,1,1) = {"
j
m
i
m
O
"}
(7,1,1) = {"
j
m
i
m
a
"}
